//MAP CONVERTED BY dmm2tgm.py THIS HEADER COMMENT PREVENTS RECONVERSION, DO NOT REMOVE
"a" = (
/obj/structure/flora/stump,
/turf/open/floor/plating/dirt/jungleland/shallow_mud,
/area/external/mining/jungleland/explored)
"b" = (
/obj/structure/closet/crate/wooden,
/obj/item/seeds/replicapod,
/obj/item/seeds/random,
/obj/item/seeds/cherry/bomb,
/turf/open/floor/wood,
/area/ruins/jungleland/unpowered/generic)
"d" = (
/obj/structure/flora/ausbushes/stalkybush,
/turf/open/water/smooth/toxic_pit,
/area/external/mining/jungleland/explored)
"e" = (
/obj/structure/fans/tiny/invisible,
/obj/structure/mineral_door/wood,
/turf/open/floor/wood,
/area/ruins/jungleland/unpowered/generic)
"g" = (
/obj/structure/closet/crate/wooden,
/obj/item/cultivator/rake,
/obj/item/hatchet/wooden,
/turf/open/floor/bamboo,
/area/ruins/jungleland/unpowered/generic)
"j" = (
/obj/machinery/hydroponics/soil,
/obj/item/cultivator/rake,
/turf/open/floor/plating/dirt/jungleland/shallow_mud,
/area/external/mining/jungleland/explored)
"l" = (
/turf/open/floor/wood,
/area/ruins/jungleland/unpowered/generic)
"m" = (
/obj/structure/curtain,
/turf/open/floor/bamboo,
/area/ruins/jungleland/unpowered/generic)
"n" = (
/obj/structure/table/wood,
/obj/structure/bedsheetbin/empty,
/turf/open/floor/bamboo,
/area/ruins/jungleland/unpowered/generic)
"p" = (
/obj/structure/curtain,
/turf/open/floor/wood,
/area/ruins/jungleland/unpowered/generic)
"q" = (
/obj/structure/flora/rock/pile,
/turf/open/floor/plating/dirt/jungleland/shallow_mud,
/area/external/mining/jungleland/explored)
"s" = (
/mob/living/simple_animal/hostile/asteroid/yog_jungle/meduracha,
/turf/open/water/smooth/toxic_pit,
/area/external/mining/jungleland/explored)
"t" = (
/obj/structure/chair/sofa/bamboo/right,
/turf/open/floor/wood,
/area/ruins/jungleland/unpowered/generic)
"u" = (
/obj/effect/decal/cleanable/dirt/dust,
/turf/open/floor/bamboo,
/area/ruins/jungleland/unpowered/generic)
"v" = (
/obj/structure/closet/crate/wooden,
/obj/item/stack/sheet/leather,
/obj/item/stack/sheet/leather,
/obj/item/stack/sheet/leather,
/turf/open/floor/bamboo,
/area/ruins/jungleland/unpowered/generic)
"w" = (
/obj/structure/table/wood,
/obj/item/clothing/head/rice_hat,
/turf/open/floor/bamboo,
/area/ruins/jungleland/unpowered/generic)
"x" = (
/obj/machinery/hydroponics/soil,
/obj/item/shovel,
/turf/open/floor/plating/dirt/jungleland/shallow_mud,
/area/external/mining/jungleland/explored)
"y" = (
/obj/machinery/hydroponics/soil,
/obj/item/seeds/wheat/rice,
/turf/open/floor/plating/dirt/jungleland/shallow_mud,
/area/external/mining/jungleland/explored)
"A" = (
/obj/structure/mineral_door/wood,
/turf/open/floor/bamboo,
/area/ruins/jungleland/unpowered/generic)
"B" = (
/obj/structure/bed,
/obj/item/bedsheet/brown,
/obj/item/clothing/accessory/resinband{
	desc = "A weird armband, doesn't look like it'd be from around here."
	},
/obj/item/clothing/suit/yogs/monkrobes,
/turf/open/floor/bamboo,
/area/ruins/jungleland/unpowered/generic)
"C" = (
/turf/open/floor/bamboo,
/area/ruins/jungleland/unpowered/generic)
"D" = (
/turf/open/floor/wood/jungle,
/area/external/mining/jungleland/explored)
"E" = (
/obj/structure/dresser,
/turf/open/floor/bamboo,
/area/ruins/jungleland/unpowered/generic)
"F" = (
/obj/structure/table/wood,
/obj/item/flashlight/lantern,
/turf/open/floor/bamboo,
/area/ruins/jungleland/unpowered/generic)
"G" = (
/turf/open/floor/plating/dirt/jungleland/shallow_mud,
/area/external/mining/jungleland/explored)
"I" = (
/obj/machinery/hydroponics/soil,
/turf/open/floor/plating/dirt/jungleland/shallow_mud,
/area/external/mining/jungleland/explored)
"K" = (
/obj/structure/chair/sofa/bamboo/left,
/turf/open/floor/wood{
	icon_state = "wood-broken6";
	tag = ""
	},
/area/ruins/jungleland/unpowered/generic)
"L" = (
/turf/open/water/smooth/toxic_pit,
/area/external/mining/jungleland/explored)
"M" = (
/obj/item/seeds/wheat/rice,
/turf/open/floor/plating/dirt/jungleland/shallow_mud,
/area/external/mining/jungleland/explored)
"N" = (
/obj/structure/table/wood,
/obj/item/book_of_babel,
/turf/open/floor/bamboo,
/area/ruins/jungleland/unpowered/generic)
"O" = (
/obj/structure/table,
/obj/item/kitchen/knife/butcher,
/turf/open/floor/wood,
/area/ruins/jungleland/unpowered/generic)
"P" = (
/obj/effect/decal/cleanable/dirt/dust,
/turf/open/floor/wood,
/area/ruins/jungleland/unpowered/generic)
"Q" = (
/obj/effect/decal/cleanable/dirt/dust,
/obj/structure/table/wood,
/turf/open/floor/bamboo,
/area/ruins/jungleland/unpowered/generic)
"R" = (
/obj/effect/decal/cleanable/blood/old,
/turf/open/floor/wood,
/area/ruins/jungleland/unpowered/generic)
"S" = (
/obj/structure/closet/crate/wooden,
/obj/item/seeds/wheat/rice,
/obj/item/seeds/wheat/rice,
/obj/item/seeds/wheat/rice,
/obj/item/seeds/wheat/rice,
/turf/open/floor/plating/dirt/jungleland/shallow_mud,
/area/external/mining/jungleland/explored)
"T" = (
/obj/structure/table/wood,
/turf/open/floor/bamboo,
/area/ruins/jungleland/unpowered/generic)
"U" = (
/turf/open/floor/wood{
	icon_state = "wood-broken4";
	tag = ""
	},
/area/ruins/jungleland/unpowered/generic)
"W" = (
/obj/structure/chair/stool/bamboo,
/turf/open/floor/bamboo,
/area/ruins/jungleland/unpowered/generic)
"X" = (
/turf/closed/wall/mineral/wood,
/area/ruins/jungleland/unpowered/generic)
"Y" = (
/obj/structure/table,
/obj/item/reagent_containers/food/snacks/meat/slab/human/mutant/zombie,
/turf/open/floor/wood,
/area/ruins/jungleland/unpowered/generic)
"Z" = (
/obj/structure/flora/ausbushes/reedbush,
/turf/open/water/smooth/toxic_pit,
/area/external/mining/jungleland/explored)

(1,1,1) = {"
G
G
G
G
G
G
G
G
G
G
G
G
G
G
G
G
G
G
G
G
G
G
G
G
G
"}
(2,1,1) = {"
G
G
x
I
I
I
I
I
I
I
I
I
I
I
I
I
I
I
G
I
I
I
I
I
G
"}
(3,1,1) = {"
G
G
L
L
L
L
L
L
L
d
L
L
L
L
L
L
L
L
L
L
Z
L
L
L
G
"}
(4,1,1) = {"
G
G
I
I
I
I
I
I
I
I
I
I
I
I
I
a
I
y
I
I
G
I
I
I
G
"}
(5,1,1) = {"
G
G
L
L
L
d
L
L
L
Z
L
L
L
L
L
L
L
L
L
L
L
L
L
L
G
"}
(6,1,1) = {"
G
G
I
I
I
I
I
I
I
G
I
I
I
I
I
I
I
I
I
I
I
I
G
I
G
"}
(7,1,1) = {"
G
G
L
L
L
L
L
L
L
L
L
L
L
s
L
L
L
L
d
L
d
L
L
L
G
"}
(8,1,1) = {"
G
G
y
I
I
I
I
I
I
I
I
I
I
I
I
I
I
I
I
I
I
I
I
I
G
"}
(9,1,1) = {"
G
G
L
L
L
L
L
L
L
L
L
L
L
L
L
L
L
L
L
L
L
L
L
L
G
"}
(10,1,1) = {"
G
G
I
I
I
I
I
I
I
I
I
I
G
j
I
I
I
I
I
I
I
I
I
I
G
"}
(11,1,1) = {"
G
G
L
L
L
d
L
L
L
L
L
L
L
L
L
L
L
L
Z
L
L
L
L
L
G
"}
(12,1,1) = {"
G
G
I
I
I
I
I
I
I
I
I
G
I
I
I
G
q
I
I
I
I
I
I
I
G
"}
(13,1,1) = {"
G
G
L
L
L
L
L
L
L
L
L
L
d
L
L
L
L
L
L
L
L
L
L
L
G
"}
(14,1,1) = {"
G
G
I
I
I
I
I
I
I
G
G
G
G
G
G
G
G
G
G
G
G
G
G
G
G
"}
(15,1,1) = {"
G
G
L
L
L
L
L
L
L
G
G
G
G
G
G
G
S
X
X
X
X
X
G
G
G
"}
(16,1,1) = {"
G
G
I
I
q
I
I
I
G
G
G
D
D
D
D
D
D
X
n
T
Q
X
G
G
G
"}
(17,1,1) = {"
G
G
L
L
d
L
L
L
L
G
G
D
D
D
D
D
D
e
u
W
w
X
G
G
G
"}
(18,1,1) = {"
G
G
I
I
I
I
I
I
I
G
G
X
X
X
X
X
X
X
C
C
F
X
G
G
G
"}
(19,1,1) = {"
G
G
L
L
L
L
L
L
L
G
G
X
N
C
X
l
l
m
C
C
g
X
G
G
G
"}
(20,1,1) = {"
G
G
I
I
I
I
I
M
I
G
G
X
B
C
A
P
l
m
u
C
v
X
G
G
G
"}
(21,1,1) = {"
G
G
L
L
L
L
L
L
L
G
G
X
E
u
X
t
l
X
X
X
X
X
G
G
G
"}
(22,1,1) = {"
G
G
I
I
I
I
I
I
I
G
G
X
X
X
X
K
l
p
l
P
O
X
G
G
G
"}
(23,1,1) = {"
G
G
L
L
L
L
L
L
d
G
G
X
b
l
l
l
l
p
U
R
Y
X
G
G
G
"}
(24,1,1) = {"
G
G
I
I
I
I
I
I
I
G
G
X
X
X
X
X
X
X
X
X
X
X
G
G
G
"}
(25,1,1) = {"
G
G
G
G
G
G
G
G
G
G
G
G
G
G
G
G
G
G
G
G
G
G
G
G
G
"}
