//MAP CONVERTED BY dmm2tgm.py THIS HEADER COMMENT PREVENTS RECONVERSION, DO NOT REMOVE
"j" = (
/turf/open/floor/plating/dirt/jungleland/shallow_mud,
/area/ruins/jungleland/unpowered/generic)
"k" = (
/obj/item/stack/sheet/bone,
/turf/open/floor/plating/dirt/jungleland/shallow_mud,
/area/ruins/jungleland/unpowered/generic)
"l" = (
/obj/effect/decal/remains/human,
/obj/item/pickaxe/silver,
/turf/open/floor/plating/dirt/jungleland/shallow_mud,
/area/ruins/jungleland/unpowered/generic)
"s" = (
/obj/effect/decal/remains/human,
/obj/item/reagent_containers/food/snacks/meat/slab/human/mutant/zombie,
/turf/open/floor/plating/dirt/jungleland/shallow_mud,
/area/ruins/jungleland/unpowered/generic)
"w" = (
/obj/effect/decal/remains/human,
/obj/item/clothing/suit/space/hardsuit/powerarmor_t45b,
/obj/item/clothing/gloves/combat,
/turf/open/floor/plating/dirt/jungleland/shallow_mud,
/area/ruins/jungleland/unpowered/generic)
"x" = (
/turf/closed/mineral/ash_rock/jungle/deepjungle,
/area/ruins/jungleland/unpowered/generic)
"y" = (
/obj/structure/flora/ash/tall_shroom,
/turf/open/floor/plating/dirt/jungleland/shallow_mud,
/area/ruins/jungleland/unpowered/generic)
"z" = (
/obj/item/stack/sheet/bone,
/obj/item/reagent_containers/autoinjector/medipen/survival,
/turf/open/floor/plating/dirt/jungleland/shallow_mud,
/area/ruins/jungleland/unpowered/generic)
"A" = (
/obj/structure/spawner/mining/basilisk,
/turf/open/floor/plating/dirt/jungleland/shallow_mud,
/area/ruins/jungleland/unpowered/generic)
"C" = (
/turf/open/floor/plating/dirt/jungleland/jungle,
/area/external/mining/jungleland/explored)
"F" = (
/turf/open/water/smooth/toxic_pit,
/area/ruins/jungleland/unpowered/generic)
"H" = (
/obj/structure/flora/ash/cap_shroom,
/turf/open/floor/plating/dirt/jungleland/shallow_mud,
/area/ruins/jungleland/unpowered/generic)
"K" = (
/obj/item/reagent_containers/food/snacks/meat/slab/human/mutant/zombie,
/turf/open/floor/plating/dirt/jungleland/shallow_mud,
/area/ruins/jungleland/unpowered/generic)
"N" = (
/obj/structure/flora/ash/stem_shroom,
/turf/open/floor/plating/dirt/jungleland/shallow_mud,
/area/ruins/jungleland/unpowered/generic)
"O" = (
/turf/open/floor/plating/dirt/jungleland/shallow_mud,
/area/external/mining/jungleland/explored)
"P" = (
/obj/structure/flora/ash/cacti,
/turf/open/floor/plating/dirt/jungleland/shallow_mud,
/area/ruins/jungleland/unpowered/generic)
"R" = (
/turf/open/water/smooth/toxic_pit,
/area/external/mining/jungleland/explored)
"X" = (
/turf/closed/mineral/ash_rock/jungle/deepjungle,
/area/external/mining/jungleland/explored)

(1,1,1) = {"
X
O
O
x
x
x
x
x
x
x
x
x
x
x
x
x
C
C
x
x
x
x
x
x
x
x
x
x
C
C
"}
(2,1,1) = {"
O
O
x
x
x
x
x
x
x
x
x
x
x
x
x
x
C
x
x
x
x
x
x
x
x
x
x
x
x
C
"}
(3,1,1) = {"
O
x
x
x
x
x
x
x
x
x
x
x
x
x
x
x
x
x
x
x
x
x
j
j
y
x
x
x
x
C
"}
(4,1,1) = {"
O
x
x
x
x
x
x
x
j
j
j
x
x
x
x
x
x
x
x
x
x
j
j
j
j
x
x
x
x
x
"}
(5,1,1) = {"
x
x
x
x
x
x
j
N
j
j
j
s
x
x
x
x
x
x
x
x
x
j
x
j
j
x
x
x
x
x
"}
(6,1,1) = {"
x
x
x
x
x
j
j
j
j
A
j
z
x
x
x
x
x
x
x
x
j
j
x
x
x
x
x
x
x
x
"}
(7,1,1) = {"
x
x
x
x
j
j
j
j
j
j
j
j
x
x
x
x
x
x
x
x
j
x
x
x
x
x
x
x
x
x
"}
(8,1,1) = {"
x
x
x
x
j
j
K
k
j
j
j
x
x
x
x
x
x
x
x
x
j
x
x
x
x
x
x
x
x
x
"}
(9,1,1) = {"
x
x
x
j
j
x
x
j
w
x
x
x
x
x
x
x
x
x
x
x
j
j
j
x
x
x
x
x
x
x
"}
(10,1,1) = {"
x
x
x
j
x
x
x
x
x
x
x
x
x
x
x
x
x
x
x
x
j
j
j
x
x
x
x
x
F
R
"}
(11,1,1) = {"
x
x
x
j
x
x
x
x
x
x
x
x
x
x
x
x
x
x
j
j
j
j
j
j
j
x
x
x
F
O
"}
(12,1,1) = {"
x
x
x
j
x
x
x
x
x
x
x
x
x
x
x
x
x
x
j
j
x
x
x
j
j
x
x
x
j
O
"}
(13,1,1) = {"
x
x
x
j
x
x
x
x
x
x
x
x
x
x
x
x
j
j
j
j
x
x
x
x
j
j
j
x
O
O
"}
(14,1,1) = {"
x
x
x
j
x
x
x
x
x
x
x
x
x
x
x
j
j
j
j
x
x
x
x
x
j
j
j
j
j
O
"}
(15,1,1) = {"
x
x
x
j
j
x
x
x
x
x
x
x
x
x
x
j
x
j
x
x
x
x
x
x
j
j
j
j
j
O
"}
(16,1,1) = {"
x
x
x
j
j
j
j
x
x
j
j
x
x
x
x
j
j
j
j
x
x
x
x
x
x
x
x
x
O
O
"}
(17,1,1) = {"
x
x
x
x
j
j
j
j
j
j
j
j
j
x
x
j
j
j
x
x
x
x
x
x
x
x
x
x
O
O
"}
(18,1,1) = {"
x
x
x
x
x
x
j
j
j
j
j
j
j
j
j
j
x
x
x
x
x
x
x
x
x
x
x
x
j
O
"}
(19,1,1) = {"
x
x
x
x
x
x
x
x
x
x
x
x
x
x
x
j
P
x
x
x
x
x
x
x
x
x
x
x
j
O
"}
(20,1,1) = {"
x
x
x
x
x
x
x
x
x
x
x
x
x
x
x
j
j
x
x
x
x
x
x
x
x
x
x
x
x
x
"}
(21,1,1) = {"
x
x
x
x
x
x
x
x
x
x
x
x
x
x
j
j
j
x
x
x
x
j
H
x
x
x
x
x
x
x
"}
(22,1,1) = {"
x
x
x
x
x
x
x
x
x
x
x
x
x
j
j
x
j
j
x
x
x
j
j
j
j
x
x
x
x
x
"}
(23,1,1) = {"
x
x
x
x
x
x
x
x
x
x
x
x
j
j
x
x
x
j
j
j
j
j
j
j
j
x
x
x
x
x
"}
(24,1,1) = {"
x
x
x
x
x
x
x
x
x
x
x
x
j
x
x
x
x
x
x
j
x
j
j
l
x
x
x
x
x
x
"}
(25,1,1) = {"
x
x
x
x
x
x
x
x
x
x
x
x
j
x
x
x
x
x
x
x
x
j
j
j
x
x
x
x
x
x
"}
(26,1,1) = {"
x
x
x
x
x
x
x
x
x
x
x
x
x
x
x
x
x
x
x
x
x
x
x
x
x
x
x
x
x
x
"}
(27,1,1) = {"
x
x
x
x
x
x
x
x
x
x
x
x
x
x
x
x
x
x
x
x
x
x
x
x
x
x
x
x
x
R
"}
(28,1,1) = {"
R
x
x
x
x
x
x
x
x
x
x
x
x
x
x
x
x
x
x
x
x
x
x
x
x
x
x
x
x
R
"}
(29,1,1) = {"
R
x
x
x
x
x
x
x
x
x
x
x
x
x
x
x
x
x
C
C
x
x
x
x
x
x
x
x
x
R
"}
(30,1,1) = {"
R
R
x
x
x
x
x
x
x
x
x
x
x
x
C
C
x
C
C
C
x
x
x
x
x
x
x
x
x
R
"}
