//MAP CONVERTED BY dmm2tgm.py THIS HEADER COMMENT PREVENTS RECONVERSION, DO NOT REMOVE
"a" = (
/obj/structure/elite_tumor,
/turf/open/floor/plating/asteroid/basalt/lava_land_surface,
/area/external/mining/lavaland/explored)
"b" = (
/turf/template_noop,
/area/template_noop)
"c" = (
/turf/open/floor/plating/asteroid/basalt/lava_land_surface,
/area/external/mining/lavaland/explored)

(1,1,1) = {"
b
b
b
b
b
"}
(2,1,1) = {"
b
c
c
c
b
"}
(3,1,1) = {"
b
c
a
c
b
"}
(4,1,1) = {"
b
c
c
c
b
"}
(5,1,1) = {"
b
b
b
b
b
"}
