//MAP CONVERTED BY dmm2tgm.py THIS HEADER COMMENT PREVENTS RECONVERSION, DO NOT REMOVE
"a" = (
/turf/open/floor/plasteel/stairs/goon/stairs2_wide{
	dir = 1
	},
/area/ruins/lavaland/unpowered/generic)
"b" = (
/obj/structure/closet/crate/large,
/obj/effect/decal/cleanable/dirt/dust,
/obj/effect/spawner/lootdrop/maintenance{
	lootcount = 4;
	name = "4maintenance loot spawner"
	},
/turf/open/floor/plating/lavaland_baseturf,
/area/ruins/lavaland/unpowered/generic)
"c" = (
/obj/effect/turf_decal/ramp_middle,
/turf/open/floor/plating/lavaland_baseturf{
	icon_state = "panelscorched"
	},
/area/ruins/lavaland/unpowered/generic)
"e" = (
/obj/structure/railing{
	dir = 8
	},
/obj/effect/turf_decal/ramp_middle{
	dir = 4
	},
/turf/open/floor/plasteel/lavaland,
/area/ruins/lavaland/unpowered/generic)
"g" = (
/turf/open/floor/plasteel/stairs/goon/dark_stairs_wide2{
	dir = 1
	},
/area/ruins/lavaland/unpowered/generic)
"h" = (
/obj/effect/turf_decal/ramp_corner{
	dir = 4
	},
/turf/open/lava/smooth/lava_land_surface,
/area/external/mining/lavaland/explored)
"j" = (
/turf/open/floor/plating/lavaland_baseturf,
/area/ruins/lavaland/unpowered/generic)
"l" = (
/obj/effect/decal/remains/human{
	layer = 3.01
	},
/obj/item/kitchen/knife/combat,
/turf/open/floor/plating/lavaland_baseturf{
	icon_state = "platingdmg3"
	},
/area/ruins/lavaland/unpowered/generic)
"m" = (
/obj/effect/decal/remains/human,
/turf/open/floor/plating/lavaland_baseturf{
	icon_state = "panelscorched"
	},
/area/ruins/lavaland/unpowered/generic)
"o" = (
/obj/effect/decal/cleanable/dirt/dust,
/turf/template_noop,
/area/template_noop)
"p" = (
/turf/template_noop,
/area/template_noop)
"q" = (
/obj/effect/turf_decal/ramp_corner{
	dir = 4
	},
/turf/open/floor/plasteel/lavaland,
/area/ruins/lavaland/unpowered/generic)
"t" = (
/obj/effect/decal/cleanable/dirt/dust,
/obj/effect/decal/cleanable/blood/splatter,
/turf/open/floor/plasteel/lavaland,
/area/ruins/lavaland/unpowered/generic)
"u" = (
/turf/open/lava/smooth/lava_land_surface,
/area/ruins/lavaland/unpowered/generic)
"v" = (
/turf/closed/wall/rust,
/area/ruins/lavaland/unpowered/generic)
"w" = (
/turf/open/floor/plasteel/stairs/goon/dark_stairs_wide{
	dir = 1
	},
/area/ruins/lavaland/unpowered/generic)
"x" = (
/turf/open/floor/plating/lavaland_baseturf{
	icon_state = "panelscorched"
	},
/area/external/mining/lavaland/explored)
"y" = (
/turf/open/floor/plasteel/stairs/goon/stairs_middle{
	dir = 1
	},
/area/ruins/lavaland/unpowered/generic)
"A" = (
/obj/effect/turf_decal/ramp_middle,
/turf/open/lava/smooth/lava_land_surface,
/area/external/mining/lavaland/explored)
"B" = (
/turf/closed/wall/mineral/wood/nonmetal,
/area/ruins/lavaland/unpowered/generic)
"C" = (
/obj/effect/decal/cleanable/dirt/dust,
/obj/effect/turf_decal/ramp_middle,
/turf/open/floor/plasteel/lavaland,
/area/ruins/lavaland/unpowered/generic)
"D" = (
/obj/effect/decal/cleanable/dirt/dust,
/turf/open/floor/plating/lavaland_baseturf{
	icon_state = "platingdmg3"
	},
/area/ruins/lavaland/unpowered/generic)
"E" = (
/turf/open/floor/plasteel/lavaland,
/area/ruins/lavaland/unpowered/generic)
"F" = (
/obj/item/ammo_casing/a546,
/obj/machinery/door/airlock/command{
	desc = "Appears to be stuck.";
	locked = 1;
	name = "door"
	},
/turf/open/floor/plating/lavaland_baseturf{
	icon_state = "panelscorched"
	},
/area/ruins/lavaland/unpowered/generic)
"G" = (
/turf/open/floor/plating/lavaland_baseturf{
	icon_state = "platingdmg3"
	},
/area/external/mining/lavaland/explored)
"H" = (
/turf/closed/wall,
/area/ruins/lavaland/unpowered/generic)
"I" = (
/turf/open/floor/plating/asteroid/basalt/lava_land_surface,
/area/external/mining/lavaland/explored)
"J" = (
/turf/open/lava/smooth/lava_land_surface,
/area/external/mining/lavaland/explored)
"K" = (
/obj/effect/decal/cleanable/dirt/dust,
/turf/open/floor/plating/lavaland_baseturf,
/area/ruins/lavaland/unpowered/generic)
"L" = (
/turf/closed/indestructible/rock,
/area/external/mining/lavaland/explored)
"M" = (
/obj/effect/turf_decal/trimline/red,
/turf/open/floor/plasteel/lavaland,
/area/ruins/lavaland/unpowered/generic)
"N" = (
/obj/effect/decal/cleanable/dirt/dust,
/turf/open/floor/plating/lavaland_baseturf{
	icon_state = "panelscorched"
	},
/area/ruins/lavaland/unpowered/generic)
"O" = (
/turf/open/floor/plating/asteroid/basalt/lava_land_surface,
/area/ruins/lavaland/unpowered/generic)
"P" = (
/turf/open/floor/plating/lavaland_baseturf{
	icon_state = "panelscorched"
	},
/area/ruins/lavaland/unpowered/generic)
"R" = (
/turf/open/floor/plasteel/lavaland,
/area/external/mining/lavaland/explored)
"S" = (
/mob/living/simple_animal/hostile/syndicate/ranged,
/turf/open/floor/plasteel/lavaland,
/area/ruins/lavaland/unpowered/generic)
"T" = (
/obj/effect/turf_decal/ramp_middle,
/turf/open/floor/plasteel/lavaland,
/area/ruins/lavaland/unpowered/generic)
"U" = (
/obj/effect/turf_decal/ramp_middle{
	dir = 8
	},
/turf/open/floor/plasteel/stairs/goon/stairs2_wide{
	dir = 1
	},
/area/ruins/lavaland/unpowered/generic)
"V" = (
/obj/effect/decal/cleanable/dirt/dust,
/turf/open/floor/plasteel/lavaland,
/area/external/mining/lavaland/explored)
"W" = (
/obj/effect/decal/cleanable/dirt/dust,
/turf/open/floor/plasteel/lavaland,
/area/ruins/lavaland/unpowered/generic)
"X" = (
/obj/effect/turf_decal/ramp_middle,
/turf/open/floor/plating/lavaland_baseturf{
	icon_state = "platingdmg3"
	},
/area/ruins/lavaland/unpowered/generic)
"Y" = (
/turf/open/floor/plating/lavaland_baseturf{
	icon_state = "platingdmg3"
	},
/area/ruins/lavaland/unpowered/generic)

(1,1,1) = {"
p
p
p
p
p
p
p
p
p
p
p
p
p
p
p
p
p
p
p
p
"}
(2,1,1) = {"
p
p
p
p
p
v
v
v
H
p
p
J
p
p
p
p
p
p
p
p
"}
(3,1,1) = {"
p
p
p
p
p
v
W
j
H
p
p
J
J
J
J
p
p
p
p
p
"}
(4,1,1) = {"
p
p
H
v
H
H
q
D
H
H
h
J
J
J
J
p
p
p
p
p
"}
(5,1,1) = {"
p
p
v
E
E
w
C
W
w
w
A
J
J
x
J
J
p
p
p
p
"}
(6,1,1) = {"
p
p
v
E
W
g
T
E
g
g
c
P
J
J
J
I
p
p
p
p
"}
(7,1,1) = {"
p
p
v
E
E
H
v
Y
v
H
H
P
J
J
I
I
I
p
p
p
"}
(8,1,1) = {"
p
J
v
W
E
H
L
I
I
I
I
I
I
I
I
I
I
I
p
p
"}
(9,1,1) = {"
p
J
J
E
t
H
L
L
H
H
v
Y
v
H
H
H
v
I
L
p
"}
(10,1,1) = {"
p
p
H
l
m
v
L
B
B
B
W
E
E
y
y
T
I
I
L
p
"}
(11,1,1) = {"
H
H
H
H
F
v
v
B
B
b
W
K
j
a
U
X
I
R
L
p
"}
(12,1,1) = {"
v
E
B
E
E
E
B
E
B
E
E
W
W
e
e
H
I
G
L
p
"}
(13,1,1) = {"
Y
W
E
E
W
W
E
W
W
E
O
Y
N
E
W
v
J
L
p
p
"}
(14,1,1) = {"
v
B
B
E
K
E
N
P
P
M
E
O
u
W
E
v
L
L
p
p
"}
(15,1,1) = {"
v
B
B
K
K
E
O
u
N
B
j
N
E
B
B
H
L
p
p
p
"}
(16,1,1) = {"
H
B
B
K
E
E
E
P
W
E
K
K
W
B
B
H
L
p
p
p
"}
(17,1,1) = {"
v
N
N
m
S
B
B
E
W
O
j
j
W
W
E
I
p
p
p
p
"}
(18,1,1) = {"
I
I
J
N
I
B
B
B
E
W
W
u
O
j
E
G
p
p
p
p
"}
(19,1,1) = {"
p
J
x
p
I
p
p
p
I
G
I
o
E
E
p
p
p
p
p
p
"}
(20,1,1) = {"
p
p
p
p
p
p
I
p
p
V
V
o
I
I
p
p
p
p
p
p
"}
