//MAP CONVERTED BY dmm2tgm.py THIS HEADER COMMENT PREVENTS RECONVERSION, DO NOT REMOVE
"aa" = (
/turf/template_noop,
/area/template_noop)
"ac" = (
/obj/item/stack/medical/ointment,
/obj/structure/table,
/obj/item/stack/medical/bruise_pack,
/turf/open/floor/plating,
/area/ruins/lavaland/powered/biodome/snow)
"ad" = (
/obj/structure/table,
/obj/item/stack/medical/gauze,
/obj/item/stack/medical/gauze,
/obj/machinery/light/small{
	dir = 1
	},
/turf/open/floor/plating,
/area/ruins/lavaland/powered/biodome/snow)
"ae" = (
/obj/machinery/power/smes,
/turf/open/floor/plating,
/area/ruins/lavaland/powered/biodome/snow)
"af" = (
/turf/open/floor/plating,
/area/ruins/lavaland/powered/biodome/snow)
"ag" = (
/obj/structure/reagent_dispensers/beerkeg,
/obj/machinery/light/small{
	dir = 1
	},
/turf/open/floor/plating,
/area/ruins/lavaland/powered/biodome/snow)
"ah" = (
/obj/item/reagent_containers/food/drinks/mug,
/turf/open/floor/plating,
/area/ruins/lavaland/powered/biodome/snow)
"ai" = (
/obj/machinery/shower,
/turf/open/floor/plating,
/area/ruins/lavaland/powered/biodome/snow)
"aj" = (
/obj/structure/sink,
/obj/machinery/light/small{
	dir = 1
	},
/turf/open/floor/plating,
/area/ruins/lavaland/powered/biodome/snow)
"ak" = (
/turf/open/floor/plating/asteroid/snow{
	initial_gas_mix = "o2=22;n2=82;TEMP=180"
	},
/area/ruins/lavaland/powered/biodome/snow)
"al" = (
/obj/effect/decal/cleanable/oil,
/turf/open/floor/plating,
/area/ruins/lavaland/powered/biodome/snow)
"am" = (
/obj/machinery/door/airlock/hatch,
/turf/open/floor/plating,
/area/ruins/lavaland/powered/biodome/snow)
"an" = (
/obj/structure/toilet{
	dir = 8
	},
/turf/open/floor/plating,
/area/ruins/lavaland/powered/biodome/snow)
"ao" = (
/turf/open/floor/plating/ice{
	initial_gas_mix = "o2=22;n2=82;TEMP=180"
	},
/area/ruins/lavaland/powered/biodome/snow)
"ap" = (
/obj/structure/flora/rock/icy,
/turf/open/floor/plating/asteroid/snow{
	initial_gas_mix = "o2=22;n2=82;TEMP=180"
	},
/area/ruins/lavaland/powered/biodome/snow)
"aq" = (
/turf/closed/wall/mineral/wood,
/area/ruins/lavaland/powered/biodome/snow)
"ar" = (
/obj/machinery/door/airlock/wood,
/turf/open/floor/plating,
/area/ruins/lavaland/powered/biodome/snow)
"as" = (
/obj/structure/fans,
/turf/closed/wall/mineral/wood,
/area/ruins/lavaland/powered/biodome/snow)
"at" = (
/turf/open/floor/wood,
/area/ruins/lavaland/powered/biodome/snow)
"au" = (
/obj/structure/bed,
/obj/item/bedsheet/blue,
/turf/open/floor/wood,
/area/ruins/lavaland/powered/biodome/snow)
"av" = (
/obj/structure/bookcase/random,
/turf/open/floor/wood,
/area/ruins/lavaland/powered/biodome/snow)
"aw" = (
/obj/structure/table/wood,
/turf/open/floor/wood,
/area/ruins/lavaland/powered/biodome/snow)
"ax" = (
/obj/structure/table/wood,
/obj/item/reagent_containers/food/snacks/beans,
/turf/open/floor/wood,
/area/ruins/lavaland/powered/biodome/snow)
"ay" = (
/obj/structure/closet/crate/trashcart,
/obj/item/trash/semki,
/obj/item/trash/candy,
/turf/open/floor/plating/asteroid/snow{
	initial_gas_mix = "o2=22;n2=82;TEMP=180"
	},
/area/ruins/lavaland/powered/biodome/snow)
"az" = (
/obj/structure/flora/tree/pine,
/turf/open/floor/plating/asteroid/snow{
	initial_gas_mix = "o2=22;n2=82;TEMP=180"
	},
/area/ruins/lavaland/powered/biodome/snow)
"aA" = (
/obj/structure/chair/comfy/brown{
	dir = 4
	},
/turf/open/floor/wood,
/area/ruins/lavaland/powered/biodome/snow)
"aB" = (
/obj/structure/flora/rock/pile/icy,
/turf/open/floor/plating/asteroid/snow{
	initial_gas_mix = "o2=22;n2=82;TEMP=180"
	},
/area/ruins/lavaland/powered/biodome/snow)
"aC" = (
/obj/structure/flora/tree/dead,
/turf/open/floor/plating/asteroid/snow{
	initial_gas_mix = "o2=22;n2=82;TEMP=180"
	},
/area/ruins/lavaland/powered/biodome/snow)
"aD" = (
/obj/machinery/door/airlock/wood,
/turf/open/floor/wood,
/area/ruins/lavaland/powered/biodome/snow)
"aE" = (
/obj/structure/extinguisher_cabinet,
/turf/closed/wall/mineral/wood,
/area/ruins/lavaland/powered/biodome/snow)
"aF" = (
/obj/structure/table/wood,
/obj/item/reagent_containers/food/drinks/mug/coco,
/turf/open/floor/wood,
/area/ruins/lavaland/powered/biodome/snow)
"aG" = (
/obj/structure/chair/comfy/brown{
	dir = 8
	},
/turf/open/floor/wood,
/area/ruins/lavaland/powered/biodome/snow)
"aH" = (
/mob/living/simple_animal/hostile/skeleton/eskimo,
/turf/open/floor/wood,
/area/ruins/lavaland/powered/biodome/snow)
"aI" = (
/obj/structure/flora/bush,
/turf/open/floor/plating/asteroid/snow{
	initial_gas_mix = "o2=22;n2=82;TEMP=180"
	},
/area/ruins/lavaland/powered/biodome/snow)
"aJ" = (
/obj/vehicle/ridden/atv,
/turf/open/floor/plating/asteroid/snow{
	initial_gas_mix = "o2=22;n2=82;TEMP=180"
	},
/area/ruins/lavaland/powered/biodome/snow)
"aM" = (
/turf/open/floor/carpet,
/area/ruins/lavaland/powered/biodome/snow)
"aN" = (
/obj/structure/bed/dogbed,
/turf/open/floor/wood,
/area/ruins/lavaland/powered/biodome/snow)
"aO" = (
/obj/machinery/door/airlock/glass_large,
/obj/structure/fans/tiny,
/turf/open/floor/pod/dark,
/area/ruins/lavaland/powered/biodome/snow)
"aP" = (
/obj/structure/fans/tiny,
/turf/open/floor/pod/dark,
/area/ruins/lavaland/powered/biodome/snow)
"aQ" = (
/obj/structure/flora/grass/both,
/turf/open/floor/plating/asteroid/snow{
	initial_gas_mix = "o2=22;n2=82;TEMP=180"
	},
/area/ruins/lavaland/powered/biodome/snow)
"aR" = (
/obj/structure/flora/tree/pine/xmas,
/turf/open/floor/plating/asteroid/snow{
	initial_gas_mix = "o2=22;n2=82;TEMP=180"
	},
/area/ruins/lavaland/powered/biodome/snow)
"bl" = (
/turf/open/floor/wood{
	initial_gas_mix = "o2=22;n2=82;TEMP=180";
	name = "bridge"
	},
/area/ruins/lavaland/powered/biodome/snow)
"bv" = (
/obj/machinery/light{
	dir = 1
	},
/turf/open/floor/plating/ice{
	initial_gas_mix = "o2=22;n2=82;TEMP=180"
	},
/area/ruins/lavaland/powered/biodome/snow)
"bw" = (
/obj/machinery/light/small{
	brightness = 3;
	dir = 8
	},
/turf/open/floor/wood,
/area/ruins/lavaland/powered/biodome/snow)
"bx" = (
/obj/machinery/light{
	dir = 4
	},
/turf/open/floor/wood,
/area/ruins/lavaland/powered/biodome/snow)
"by" = (
/obj/machinery/light{
	dir = 8
	},
/turf/open/floor/plating/asteroid/snow{
	initial_gas_mix = "o2=22;n2=82;TEMP=180"
	},
/area/ruins/lavaland/powered/biodome/snow)
"bz" = (
/obj/machinery/light,
/turf/open/floor/wood,
/area/ruins/lavaland/powered/biodome/snow)
"bB" = (
/obj/machinery/light{
	dir = 4
	},
/turf/open/floor/plating/asteroid/snow{
	initial_gas_mix = "o2=22;n2=82;TEMP=180"
	},
/area/ruins/lavaland/powered/biodome/snow)
"bD" = (
/obj/machinery/light{
	dir = 1
	},
/turf/open/floor/plating/asteroid/snow{
	initial_gas_mix = "o2=22;n2=82;TEMP=180"
	},
/area/ruins/lavaland/powered/biodome/snow)
"bM" = (
/obj/machinery/light,
/turf/open/floor/plating/asteroid/snow{
	initial_gas_mix = "o2=22;n2=82;TEMP=180"
	},
/area/ruins/lavaland/powered/biodome/snow)
"bN" = (
/obj/machinery/light,
/turf/open/floor/plating/ice{
	initial_gas_mix = "o2=22;n2=82;TEMP=180"
	},
/area/ruins/lavaland/powered/biodome/snow)
"dS" = (
/obj/machinery/light/small,
/turf/open/floor/pod/dark,
/area/ruins/lavaland/powered/biodome/snow)
"eb" = (
/obj/machinery/light/small{
	dir = 4
	},
/turf/open/floor/pod/dark,
/area/ruins/lavaland/powered/biodome/snow)
"eg" = (
/obj/machinery/vending/coffee,
/turf/open/floor/pod/dark,
/area/ruins/lavaland/powered/biodome/snow)
"el" = (
/obj/effect/mapping_helpers/no_lava,
/obj/effect/mapping_helpers/no_lava,
/turf/open/floor/plating/asteroid/basalt/lava_land_surface,
/area/external/mining/lavaland/explored)
"gh" = (
/obj/machinery/light/small{
	brightness = 3;
	dir = 8
	},
/turf/open/floor/pod/dark,
/area/ruins/lavaland/powered/biodome/snow)
"gz" = (
/obj/structure/chair/stool,
/turf/open/floor/pod/dark,
/area/ruins/lavaland/powered/biodome/snow)
"hA" = (
/obj/machinery/light/built{
	dir = 1
	},
/obj/effect/mapping_helpers/no_lava,
/turf/open/floor/pod/dark{
	initial_gas_mix = "o2=14;n2=23;TEMP=300"
	},
/area/ruins/lavaland/powered/biodome/snow)
"mX" = (
/obj/effect/mapping_helpers/no_lava,
/turf/open/floor/plating/asteroid/basalt/lava_land_surface,
/area/external/mining/lavaland/explored)
"qt" = (
/obj/machinery/door/airlock/silver,
/obj/structure/fans/tiny,
/obj/effect/mapping_helpers/airlock/cyclelink_helper{
	dir = 8
	},
/turf/open/floor/pod/dark,
/area/ruins/lavaland/powered/biodome/snow)
"tl" = (
/turf/open/floor/pod/light,
/area/ruins/lavaland/powered/biodome/snow)
"xU" = (
/obj/item/storage/toolbox/mechanical,
/turf/open/floor/pod/dark,
/area/ruins/lavaland/powered/biodome/snow)
"zT" = (
/obj/machinery/door/airlock/silver,
/obj/structure/fans/tiny,
/turf/open/floor/plating,
/area/ruins/lavaland/powered/biodome/snow)
"As" = (
/obj/item/kirbyplants/random,
/turf/open/floor/wood,
/area/ruins/lavaland/powered/biodome/snow)
"AM" = (
/obj/structure/table,
/obj/item/pen,
/obj/item/paper,
/turf/open/floor/pod/dark,
/area/ruins/lavaland/powered/biodome/snow)
"Dd" = (
/obj/structure/rack,
/obj/item/clothing/suit/hooded/wintercoat/science,
/obj/item/clothing/shoes/winterboots,
/obj/item/clothing/gloves/fingerless,
/turf/open/floor/pod/dark,
/area/ruins/lavaland/powered/biodome/snow)
"Ef" = (
/obj/structure/reagent_dispensers/fueltank,
/turf/open/floor/pod/dark,
/area/ruins/lavaland/powered/biodome/snow)
"Ez" = (
/obj/structure/fans/tiny,
/obj/machinery/door/airlock/glass_large,
/turf/open/floor/pod/dark,
/area/ruins/lavaland/powered/biodome/snow)
"HP" = (
/turf/open/floor/pod/dark,
/area/ruins/lavaland/powered/biodome/snow)
"HR" = (
/obj/structure/closet/secure_closet/freezer/fridge/open,
/turf/open/floor/pod/dark,
/area/ruins/lavaland/powered/biodome/snow)
"JZ" = (
/obj/structure/table,
/obj/machinery/microwave,
/turf/open/floor/pod/dark,
/area/ruins/lavaland/powered/biodome/snow)
"KS" = (
/obj/item/melee/chainsaw,
/obj/structure/closet,
/obj/machinery/light/small{
	dir = 4
	},
/turf/open/floor/pod/dark,
/area/ruins/lavaland/powered/biodome/snow)
"Mp" = (
/obj/item/clothing/mask/balaclava,
/turf/open/floor/pod/dark,
/area/ruins/lavaland/powered/biodome/snow)
"Oj" = (
/obj/structure/table,
/turf/open/floor/pod/dark,
/area/ruins/lavaland/powered/biodome/snow)
"PD" = (
/obj/machinery/door/airlock/hatch,
/obj/structure/fans/tiny,
/obj/effect/mapping_helpers/airlock/cyclelink_helper{
	dir = 4
	},
/turf/open/floor/pod/dark,
/area/ruins/lavaland/powered/biodome/snow)
"PK" = (
/obj/structure/table,
/obj/item/pen,
/obj/item/paper_bin,
/turf/open/floor/pod/dark,
/area/ruins/lavaland/powered/biodome/snow)
"QK" = (
/obj/structure/table,
/obj/item/storage/fancy/cigarettes/cigpack_carp,
/turf/open/floor/pod/dark,
/area/ruins/lavaland/powered/biodome/snow)
"QN" = (
/obj/effect/spawner/structure/window,
/turf/open/floor/plating,
/area/ruins/lavaland/powered/biodome/snow)
"Sj" = (
/obj/effect/decal/cleanable/oil,
/turf/open/floor/pod/dark,
/area/ruins/lavaland/powered/biodome/snow)
"Ub" = (
/obj/structure/filingcabinet,
/turf/open/floor/pod/dark,
/area/ruins/lavaland/powered/biodome/snow)
"UM" = (
/obj/machinery/computer/monitor/secret{
	dir = 1
	},
/turf/open/floor/pod/dark,
/area/ruins/lavaland/powered/biodome/snow)
"VR" = (
/turf/open/floor/plating/asteroid/basalt/lava_land_surface,
/area/external/mining/lavaland/explored)
"Wg" = (
/turf/closed/wall/r_wall,
/area/ruins/lavaland/powered/biodome/snow)

(1,1,1) = {"
aa
aa
aa
aa
aa
aa
aa
aa
aa
aa
Wg
Wg
Wg
Wg
PD
Wg
Wg
Wg
Wg
aa
aa
aa
aa
aa
aa
aa
aa
aa
aa
aa
"}
(2,1,1) = {"
aa
aa
aa
aa
aa
aa
Wg
Wg
Wg
Wg
Wg
Dd
gh
HP
tl
gh
HP
Ub
Wg
Wg
Wg
Wg
Wg
aa
aa
aa
aa
aa
aa
aa
"}
(3,1,1) = {"
aa
aa
aa
aa
Wg
Wg
Wg
ak
by
ak
Wg
Dd
HP
HP
tl
PK
gz
UM
Wg
ak
ak
ak
Wg
Wg
Wg
VR
VR
aa
aa
aa
"}
(4,1,1) = {"
aa
aa
aa
Wg
Wg
ak
aC
ak
ak
ak
Wg
QN
QN
QN
qt
QN
QN
QN
Wg
ak
ak
ak
ak
ak
Wg
Wg
VR
VR
aa
aa
"}
(5,1,1) = {"
aa
aa
Wg
Wg
ao
ao
ak
aI
ak
ak
by
az
ak
aB
ak
ak
ak
aI
by
ak
ak
ak
ak
ak
ak
Wg
Wg
VR
mX
aa
"}
(6,1,1) = {"
aa
aa
Wg
bv
ao
ao
ao
ao
ak
aI
ak
ak
ak
ak
ak
ak
ak
ak
ak
aQ
ak
ak
ak
az
ak
ak
Wg
VR
mX
aa
"}
(7,1,1) = {"
aa
Wg
Wg
ap
ak
ao
ao
ao
ao
ak
ak
ak
ak
ak
az
ak
aC
ak
ak
aI
aI
ak
ak
ak
ak
bM
Wg
Wg
mX
aa
"}
(8,1,1) = {"
aa
Wg
ak
ak
ak
ak
ak
ao
ao
ao
ao
ak
ak
ak
ak
ak
ak
ak
ap
aI
ak
aQ
ak
ak
ak
az
ak
Wg
mX
mX
"}
(9,1,1) = {"
aa
Wg
Wg
Wg
ak
az
ak
ak
ao
ao
ao
ao
ao
ak
ak
ak
ak
ak
ak
ak
ak
aC
ak
ak
ak
ak
ak
Wg
hA
mX
"}
(10,1,1) = {"
Wg
Wg
af
Wg
ak
ak
ak
ak
ak
ak
ak
ao
ao
ao
ao
ak
aI
az
ak
ak
ak
ak
ak
aI
ak
ak
ak
Wg
mX
mX
"}
(11,1,1) = {"
Wg
ac
af
aq
aq
aq
aq
aq
aq
aq
bD
ao
ao
ao
ao
ao
ak
ak
bl
bl
ak
aI
ak
ak
ak
Wg
Wg
Wg
Wg
mX
"}
(12,1,1) = {"
Wg
ad
af
ar
bw
at
aD
at
As
aq
ak
az
ak
ao
ao
ao
ao
ao
bl
bl
ak
ak
ak
az
bM
Wg
Dd
Dd
Wg
mX
"}
(13,1,1) = {"
Wg
ae
af
aq
au
au
aq
at
bz
aq
ak
ak
ak
ao
ao
ao
ao
ao
bl
bl
ao
ak
ak
ak
aI
Wg
Mp
dS
Wg
mX
"}
(14,1,1) = {"
Wg
af
al
aq
aq
aq
aE
at
at
aq
ak
ak
aC
ak
ao
ak
ao
ao
bl
bl
ao
ao
aI
ak
ak
Wg
tl
tl
Wg
mX
"}
(15,1,1) = {"
Wg
ae
af
aq
av
at
at
aH
aM
aO
ap
ak
ak
ak
ak
ak
ak
ao
bl
bl
ao
ao
ak
ak
ak
aO
tl
tl
Ez
el
"}
(16,1,1) = {"
Wg
ag
ah
as
aw
aA
aA
at
aM
aP
ak
ak
aQ
ak
ak
az
ak
ak
bl
bl
ak
ao
ao
ak
ak
aP
tl
tl
aP
el
"}
(17,1,1) = {"
Wg
ah
af
aq
ax
aw
aF
at
at
aq
ak
aI
ak
ak
ak
ak
ak
ak
ak
ak
ak
ao
ao
ao
ak
Wg
tl
tl
Wg
mX
"}
(18,1,1) = {"
Wg
Wg
am
aq
av
at
aG
at
bz
aq
aR
ak
ak
ak
ak
ak
ak
ak
aC
ak
ak
ak
ao
ao
ao
Wg
HP
dS
Wg
mX
"}
(19,1,1) = {"
Wg
ai
af
aq
av
bx
aH
at
aN
aq
ak
ak
ak
az
ak
ak
ak
ak
ak
ak
ak
ak
ak
ao
bN
Wg
QK
AM
Wg
mX
"}
(20,1,1) = {"
Wg
aj
af
aq
aq
aq
aq
aq
aq
aq
bD
ak
ak
ak
ak
aI
ak
az
ak
ak
ak
ak
az
ak
ao
Wg
Wg
Wg
Wg
mX
"}
(21,1,1) = {"
Wg
Wg
an
Wg
ay
ak
ak
ak
ak
ak
ak
ak
ak
ak
aC
ak
ak
ak
ak
ap
ak
ak
ak
ak
ak
ak
ak
Wg
mX
mX
"}
(22,1,1) = {"
aa
Wg
Wg
Wg
ak
ak
aI
ak
ap
ak
ak
ak
ak
ak
ak
ak
ak
ak
ak
ak
aI
ak
ak
aQ
ak
ak
ak
Wg
hA
mX
"}
(23,1,1) = {"
aa
Wg
ak
ak
az
ak
aJ
ak
ak
ak
ak
ak
ak
az
ak
aQ
ak
aC
ak
aI
ak
az
aI
aI
ak
ak
ak
Wg
mX
mX
"}
(24,1,1) = {"
aa
Wg
Wg
ak
ak
aB
ak
ak
aC
ak
ak
ak
ak
aI
ak
ap
ak
ak
ak
ak
ak
ak
aI
aI
ak
bM
Wg
Wg
mX
aa
"}
(25,1,1) = {"
aa
aa
Wg
ap
ak
ak
ak
ak
ak
aQ
ak
ak
ak
aI
ak
ak
ak
ak
aQ
ak
ak
aB
ak
ak
aC
ak
Wg
VR
mX
aa
"}
(26,1,1) = {"
aa
aa
Wg
Wg
ak
ak
az
ak
ak
ak
bB
ak
ak
ak
ak
ak
az
ak
bB
ak
ak
az
ak
ak
ak
Wg
Wg
VR
aa
aa
"}
(27,1,1) = {"
aa
aa
aa
Wg
Wg
ak
ak
ak
ak
ak
Wg
QN
QN
QN
zT
QN
QN
QN
Wg
ak
ak
ak
ak
ak
Wg
Wg
VR
VR
aa
aa
"}
(28,1,1) = {"
aa
aa
aa
aa
Wg
Wg
Wg
ak
bB
ak
Wg
eg
HP
tl
tl
tl
Sj
xU
Wg
ak
bB
ak
Wg
Wg
Wg
VR
VR
aa
aa
aa
"}
(29,1,1) = {"
aa
aa
aa
aa
aa
aa
Wg
Wg
Wg
Wg
Wg
HR
eb
gz
Oj
JZ
KS
Ef
Wg
Wg
Wg
Wg
Wg
aa
aa
aa
aa
aa
aa
aa
"}
(30,1,1) = {"
aa
aa
aa
aa
aa
aa
aa
aa
aa
aa
Wg
Wg
Wg
Wg
Wg
Wg
Wg
Wg
Wg
aa
aa
aa
aa
aa
aa
aa
aa
aa
aa
aa
"}
