//MAP CONVERTED BY dmm2tgm.py THIS HEADER COMMENT PREVENTS RECONVERSION, DO NOT REMOVE
"a" = (
/turf/open/floor/plating/asteroid/basalt/lava_land_surface,
/area/external/mining/lavaland/explored)
"b" = (
/obj/effect/mob_spawn/human/corpse/nanotrasensoldier,
/turf/open/floor/plating/asteroid/basalt/lava_land_surface,
/area/external/mining/lavaland/explored)
"d" = (
/turf/open/lava/smooth/lava_land_surface,
/area/external/mining/lavaland/explored)
"e" = (
/mob/living/simple_animal/hostile/asteroid/goliath/beast,
/turf/open/floor/plating/asteroid/basalt/lava_land_surface,
/area/external/mining/lavaland/explored)
"f" = (
/turf/closed/mineral/volcanic/lava_land_surface,
/area/external/mining/lavaland/explored)
"g" = (
/mob/living/simple_animal/hostile/asteroid/goliath/beast,
/turf/open/floor/plating/asteroid/basalt/lava_land_surface,
/area/ruins/lavaland/unpowered/generic)
"h" = (
/turf/open/floor/plating/asteroid/basalt/lava_land_surface,
/area/ruins/lavaland/unpowered/generic)
"i" = (
/obj/item/flashlight/lantern,
/turf/open/floor/plating/asteroid/basalt/lava_land_surface,
/area/ruins/lavaland/unpowered/generic)
"j" = (
/obj/item/storage/bag/ore/holding,
/mob/living/simple_animal/hostile/asteroid/goliath/beast,
/turf/open/floor/plating/asteroid/basalt/lava_land_surface,
/area/ruins/lavaland/unpowered/generic)
"k" = (
/obj/item/lazarus_injector,
/turf/open/floor/plating/asteroid/basalt/lava_land_surface,
/area/ruins/lavaland/unpowered/generic)
"l" = (
/obj/effect/mob_spawn/human/corpse/damaged,
/obj/item/gun/energy/kinetic_accelerator,
/obj/item/borg/upgrade/modkit/chassis_mod/orange,
/obj/item/borg/upgrade/modkit/tracer/adjustable,
/obj/item/borg/upgrade/modkit/resonator_blasts,
/turf/open/floor/plating/asteroid/basalt/lava_land_surface,
/area/ruins/lavaland/unpowered/generic)
"m" = (
/obj/item/mining_voucher,
/turf/open/floor/plating/asteroid/basalt/lava_land_surface,
/area/ruins/lavaland/unpowered/generic)
"n" = (
/mob/living/simple_animal/hostile/cat_butcherer,
/turf/open/floor/plating/asteroid/basalt/lava_land_surface,
/area/ruins/lavaland/unpowered/generic)
"o" = (
/obj/item/clothing/suit/space/freedom,
/turf/open/floor/plating/asteroid/basalt/lava_land_surface,
/area/ruins/lavaland/unpowered/generic)

(1,1,1) = {"
a
a
a
a
f
a
a
a
a
f
a
f
a
f
f
a
a
a
a
"}
(2,1,1) = {"
a
a
a
a
f
a
a
f
a
a
a
a
a
f
f
a
a
a
a
"}
(3,1,1) = {"
a
d
d
a
a
a
a
e
a
a
a
a
a
a
a
a
a
a
f
"}
(4,1,1) = {"
a
a
a
a
a
b
a
a
b
a
a
d
d
d
d
b
a
f
a
"}
(5,1,1) = {"
a
a
a
a
a
d
a
a
f
a
a
a
a
f
a
a
a
e
a
"}
(6,1,1) = {"
a
d
a
a
f
d
f
a
f
d
f
d
a
f
f
a
a
a
a
"}
(7,1,1) = {"
a
f
f
a
f
f
f
f
f
f
f
f
a
a
f
d
d
d
a
"}
(8,1,1) = {"
b
f
a
a
a
f
f
f
f
f
f
f
f
f
f
a
a
a
a
"}
(9,1,1) = {"
a
a
a
a
f
f
f
f
h
g
h
g
f
f
f
f
a
a
a
"}
(10,1,1) = {"
a
a
a
a
f
f
f
g
h
n
o
f
f
f
a
a
a
f
f
"}
(11,1,1) = {"
a
f
f
a
f
f
f
h
g
k
g
h
f
f
f
d
a
a
a
"}
(12,1,1) = {"
a
a
f
e
a
f
f
h
i
l
m
g
f
f
a
d
a
b
a
"}
(13,1,1) = {"
a
a
d
a
f
f
f
h
j
m
g
h
f
f
f
f
a
a
f
"}
(14,1,1) = {"
f
a
f
a
a
f
f
g
h
h
h
h
g
f
f
f
f
a
f
"}
(15,1,1) = {"
a
a
b
a
a
f
f
f
f
g
g
h
g
f
f
a
a
e
a
"}
(16,1,1) = {"
a
a
d
a
a
a
f
f
f
f
f
f
f
f
f
f
a
a
f
"}
(17,1,1) = {"
a
a
a
a
a
a
a
f
f
f
f
f
f
f
a
a
f
a
f
"}
(18,1,1) = {"
a
d
d
d
d
a
a
f
a
f
f
f
a
a
a
a
a
a
a
"}
(19,1,1) = {"
a
a
a
f
f
f
a
d
b
a
f
d
d
a
d
d
d
d
a
"}
(20,1,1) = {"
a
f
a
a
f
f
a
a
a
e
a
a
a
a
a
a
a
f
a
"}
(21,1,1) = {"
a
a
a
a
a
a
a
a
a
a
f
f
a
a
f
a
a
a
a
"}
