//MAP CONVERTED BY dmm2tgm.py THIS HEADER COMMENT PREVENTS RECONVERSION, DO NOT REMOVE
"a" = (
/turf/closed/mineral/volcanic/lava_land_surface,
/area/external/mining/lavaland/explored)
"b" = (
/turf/closed/wall/mineral/titanium/nodiagonal,
/area/ruins/lavaland/unpowered/generic)
"c" = (
/obj/structure/falsewall/titanium,
/turf/open/floor/plating,
/area/ruins/lavaland/unpowered/generic)
"d" = (
/obj/structure/window/shuttle,
/turf/open/floor/plating/asteroid/basalt/lava,
/area/ruins/lavaland/unpowered/generic)
"e" = (
/obj/structure/closet,
/obj/item/clothing/mask/gas/mime,
/obj/item/clothing/shoes/sneakers/mime,
/obj/item/clothing/under/rank/civilian/mime,
/obj/item/toy/crayon/spraycan/mimecan,
/obj/item/toy/figure/mime,
/obj/item/storage/backpack/mime,
/obj/item/storage/box/syndie_kit/mimery,
/turf/open/floor/plasteel/white,
/area/ruins/lavaland/unpowered/generic)
"f" = (
/obj/structure/closet/crate/internals,
/obj/item/tank/internals/emergency_oxygen,
/obj/item/tank/internals/emergency_oxygen,
/turf/open/floor/plasteel/white,
/area/ruins/lavaland/unpowered/generic)
"g" = (
/obj/machinery/computer,
/turf/open/floor/plasteel/white,
/area/ruins/lavaland/unpowered/generic)
"h" = (
/obj/structure/chair{
	dir = 8
	},
/turf/open/floor/plasteel/white,
/area/ruins/lavaland/unpowered/generic)
"i" = (
/turf/open/floor/plasteel/white,
/area/ruins/lavaland/unpowered/generic)
"j" = (
/obj/structure/closet/crate,
/obj/item/tank/internals/emergency_oxygen,
/turf/open/floor/plating/asteroid/basalt/lava,
/area/ruins/lavaland/unpowered/generic)
"k" = (
/obj/structure/closet,
/obj/item/clothing/mask/gas/mime,
/obj/item/clothing/shoes/sneakers/mime,
/obj/item/clothing/under/rank/civilian/mime,
/obj/item/storage/backpack/mime,
/turf/open/floor/plating/asteroid/basalt/lava,
/area/ruins/lavaland/unpowered/generic)
"l" = (
/obj/structure/closet/crate,
/obj/item/storage/toolbox/syndicate,
/turf/open/floor/plating/asteroid/basalt/lava,
/area/ruins/lavaland/unpowered/generic)
"m" = (
/obj/structure/table_frame,
/turf/open/floor/plating/asteroid/basalt/lava,
/area/ruins/lavaland/unpowered/generic)
"n" = (
/obj/structure/table,
/obj/item/pickaxe/drill/diamonddrill,
/turf/open/floor/plating/asteroid/basalt/lava,
/area/ruins/lavaland/unpowered/generic)
"o" = (
/obj/machinery/door/airlock/silver,
/turf/open/floor/plasteel/white,
/area/ruins/lavaland/unpowered/generic)
"p" = (
/obj/item/chair,
/turf/open/floor/plasteel/white,
/area/ruins/lavaland/unpowered/generic)
"q" = (
/turf/open/floor/plating/asteroid/basalt/lava,
/area/ruins/lavaland/unpowered/generic)
"r" = (
/obj/structure/fans/tiny/invisible,
/obj/machinery/door/airlock/external/glass,
/turf/open/floor/plasteel/white,
/area/ruins/lavaland/unpowered/generic)
"s" = (
/obj/item/storage/bag/ore,
/turf/open/floor/plating/asteroid/basalt/lava,
/area/ruins/lavaland/unpowered/generic)
"t" = (
/obj/structure/table,
/obj/item/reagent_containers/food/snacks/customizable/sandwich{
	pixel_y = 6
	},
/obj/item/reagent_containers/food/snacks/customizable/sandwich{
	pixel_y = 6
	},
/obj/item/reagent_containers/food/snacks/cheesewedge,
/turf/open/floor/plating/asteroid/basalt/lava,
/area/ruins/lavaland/unpowered/generic)
"u" = (
/obj/structure/girder,
/turf/open/floor/plating/asteroid/basalt/lava,
/area/ruins/lavaland/unpowered/generic)
"v" = (
/obj/structure/closet/crate,
/turf/open/floor/plating/asteroid/basalt/lava,
/area/ruins/lavaland/unpowered/generic)
"w" = (
/obj/effect/decal/cleanable/blood/splatter,
/turf/open/floor/plating/asteroid/basalt/lava,
/area/ruins/lavaland/unpowered/generic)
"x" = (
/obj/structure/table,
/obj/item/storage/bag/ore,
/obj/item/mining_scanner,
/obj/item/clothing/glasses/meson,
/turf/open/floor/plating/asteroid/basalt/lava,
/area/ruins/lavaland/unpowered/generic)
"y" = (
/obj/effect/spawner/structure/window,
/turf/open/floor/plating,
/area/ruins/lavaland/unpowered/generic)
"z" = (
/obj/item/shard,
/obj/effect/decal/cleanable/blood/tracks,
/turf/open/floor/plating/asteroid/basalt/lava,
/area/ruins/lavaland/unpowered/generic)
"A" = (
/obj/item/shard,
/turf/open/floor/plating/asteroid/basalt/lava,
/area/ruins/lavaland/unpowered/generic)
"B" = (
/obj/structure/table,
/obj/item/pickaxe,
/obj/item/tank/internals/emergency_oxygen,
/turf/open/floor/plating/asteroid/basalt/lava,
/area/ruins/lavaland/unpowered/generic)
"C" = (
/obj/effect/mob_spawn/human/corpse/damaged,
/obj/effect/decal/cleanable/blood/splatter,
/turf/open/floor/plating/asteroid/basalt/lava,
/area/ruins/lavaland/unpowered/generic)
"D" = (
/turf/open/chasm,
/area/ruins/lavaland/unpowered/generic)
"E" = (
/obj/effect/decal/cleanable/blood/tracks,
/turf/open/floor/plating/asteroid/basalt/lava,
/area/ruins/lavaland/unpowered/generic)
"F" = (
/turf/closed/wall/r_wall,
/area/ruins/lavaland/unpowered/generic)
"G" = (
/obj/item/shard,
/obj/effect/decal/cleanable/blood/splatter,
/obj/effect/mob_spawn/human/corpse/damaged,
/turf/open/floor/plating/asteroid/basalt/lava,
/area/ruins/lavaland/unpowered/generic)
"H" = (
/obj/item/pickaxe,
/obj/effect/decal/cleanable/blood/splatter,
/turf/open/floor/plating/asteroid/basalt/lava,
/area/ruins/lavaland/unpowered/generic)
"I" = (
/obj/item/pickaxe,
/turf/open/floor/plating/asteroid/basalt/lava,
/area/ruins/lavaland/unpowered/generic)
"Z" = (
/turf/closed/mineral/volcanic/lava_land_surface,
/area/ruins/lavaland/unpowered/generic)

(1,1,1) = {"
Z
Z
Z
Z
Z
u
q
q
u
Z
a
a
a
a
a
"}
(2,1,1) = {"
Z
b
c
c
b
v
q
q
u
Z
Z
Z
Z
Z
Z
"}
(3,1,1) = {"
Z
c
e
i
r
q
q
q
q
q
u
Z
q
u
Z
"}
(4,1,1) = {"
Z
c
f
i
c
q
q
q
q
q
q
q
q
u
Z
"}
(5,1,1) = {"
Z
c
c
o
c
q
q
C
E
E
E
E
H
Z
Z
"}
(6,1,1) = {"
Z
c
g
i
c
q
y
y
y
y
y
q
q
q
Z
"}
(7,1,1) = {"
Z
c
h
i
c
q
y
D
D
D
y
q
Z
Z
Z
"}
(8,1,1) = {"
Z
d
i
p
d
q
y
D
F
D
y
q
Z
Z
a
"}
(9,1,1) = {"
Z
b
d
d
b
q
y
D
D
D
y
q
u
Z
a
"}
(10,1,1) = {"
Z
Z
j
q
s
w
z
E
E
G
y
q
q
Z
a
"}
(11,1,1) = {"
a
Z
k
q
q
q
A
q
q
q
q
q
q
Z
a
"}
(12,1,1) = {"
a
Z
l
q
q
q
q
q
A
q
q
Z
I
Z
a
"}
(13,1,1) = {"
a
Z
m
q
q
q
q
q
q
q
u
Z
w
Z
a
"}
(14,1,1) = {"
a
Z
n
q
t
x
B
q
Z
Z
Z
Z
Z
Z
a
"}
(15,1,1) = {"
a
Z
Z
Z
Z
Z
Z
Z
Z
a
a
a
a
a
a
"}
