//MAP CONVERTED BY dmm2tgm.py THIS HEADER COMMENT PREVENTS RECONVERSION, DO NOT REMOVE
"a" = (
/turf/closed/mineral/volcanic/lava_land_surface,
/area/external/mining/lavaland/explored)
"b" = (
/turf/open/floor/plating/asteroid/basalt/lava_land_surface,
/area/external/mining/lavaland/explored)
"c" = (
/obj/item/shard,
/turf/open/floor/plating/asteroid/basalt/lava_land_surface,
/area/external/mining/lavaland/explored)
"d" = (
/obj/item/shard{
	icon_state = "medium"
	},
/turf/open/floor/plating/asteroid/basalt/lava_land_surface,
/area/external/mining/lavaland/explored)
"j" = (
/obj/item/pickaxe,
/obj/item/pickaxe,
/obj/item/pickaxe,
/obj/item/pickaxe,
/obj/item/flashlight/lantern,
/obj/structure/closet/crate/engineering{
	name = "Mining Supplies"
	},
/obj/item/flashlight/lantern,
/obj/item/flashlight/lantern,
/obj/item/flashlight/lantern,
/obj/item/flashlight/lantern,
/obj/item/flashlight/lantern,
/obj/item/flashlight/lantern,
/obj/item/flashlight/lantern,
/obj/item/pickaxe,
/obj/item/pickaxe,
/obj/item/pickaxe,
/obj/item/pickaxe,
/turf/open/floor/mineral/plastitanium/red,
/area/ruins/lavaland/powered/generic)
"k" = (
/obj/effect/mob_spawn/human/prisoner_transport,
/turf/open/floor/mineral/plastitanium/red,
/area/ruins/lavaland/powered/generic)
"l" = (
/obj/machinery/door/airlock/shuttle,
/turf/open/floor/mineral/plastitanium/red{
	initial_gas_mix = "o2=14;n2=23;TEMP=300"
	},
/area/ruins/lavaland/powered/generic)
"n" = (
/obj/effect/mob_spawn/human/nanotrasensoldier,
/obj/effect/decal/cleanable/blood,
/obj/item/flashlight/seclite,
/obj/effect/light_emitter,
/turf/open/floor/mineral/plastitanium/red,
/area/ruins/lavaland/powered/generic)
"o" = (
/obj/item/gun/ballistic/automatic/pistol/m1911,
/turf/open/floor/mineral/plastitanium/red,
/area/ruins/lavaland/powered/generic)
"q" = (
/obj/machinery/door/airlock/shuttle,
/obj/structure/fans/tiny,
/turf/open/floor/mineral/plastitanium/red,
/area/ruins/lavaland/powered/generic)
"r" = (
/obj/structure/lattice,
/turf/open/floor/mineral/plastitanium/red{
	initial_gas_mix = "o2=14;n2=23;TEMP=300"
	},
/area/external/mining/lavaland/explored)
"t" = (
/obj/item/shard,
/turf/open/floor/mineral/plastitanium/red{
	initial_gas_mix = "o2=14;n2=23;TEMP=300"
	},
/area/external/mining/lavaland/explored)
"u" = (
/obj/structure/closet/crate/internals{
	desc = "An emergency supply crate with the NT logo attached to it, it has a small reading below which seems to signify that you probably shouldn't open this incase of an emergency. It also says only for security personell"
	},
/obj/item/storage/toolbox/mechanical,
/obj/item/tank/internals/emergency_oxygen,
/obj/item/tank/internals/emergency_oxygen,
/obj/item/flashlight,
/obj/item/flashlight,
/obj/item/flashlight,
/obj/item/flashlight,
/obj/item/flashlight,
/obj/item/tank/internals/emergency_oxygen,
/obj/item/stack/medical/bruise_pack,
/obj/item/stack/medical/gauze,
/obj/item/stack/medical/ointment,
/obj/item/tank/internals/emergency_oxygen,
/obj/item/tank/internals/emergency_oxygen,
/obj/item/tank/internals/emergency_oxygen,
/obj/item/tank/internals/emergency_oxygen,
/obj/item/tank/internals/emergency_oxygen,
/turf/open/floor/mineral/plastitanium/red,
/area/ruins/lavaland/powered/generic)
"v" = (
/obj/machinery/light/floor,
/turf/open/floor/mineral/plastitanium/red,
/area/ruins/lavaland/powered/generic)
"z" = (
/obj/effect/mob_spawn/human/nanotrasensoldier,
/obj/effect/decal/cleanable/blood,
/obj/item/kitchen/knife/combat/survival,
/turf/open/floor/plating/asteroid/basalt/lava_land_surface,
/area/external/mining/lavaland/explored)
"A" = (
/obj/effect/decal/cleanable/blood,
/obj/item/flashlight/seclite,
/turf/open/floor/plating/asteroid/basalt/lava_land_surface,
/area/external/mining/lavaland/explored)
"B" = (
/obj/effect/decal/cleanable/blood,
/turf/open/floor/plating/asteroid/basalt/lava_land_surface,
/area/external/mining/lavaland/explored)
"G" = (
/obj/item/gun/ballistic/automatic/pistol/m1911,
/turf/open/floor/plating/asteroid/basalt/lava_land_surface,
/area/external/mining/lavaland/explored)
"L" = (
/turf/closed/indestructible/opshuttle,
/area/ruins/lavaland/powered/generic)
"M" = (
/obj/effect/mob_spawn/human/nanotrasensoldier,
/obj/item/gun/ballistic/automatic/pistol/m1911{
	desc = "A classic .45 handgun with a small magazine capacity, this one has a name engraved on it that reads 'Samantha'";
	name = "Samantha"
	},
/obj/effect/decal/cleanable/blood,
/turf/open/floor/mineral/plastitanium/red{
	initial_gas_mix = "o2=14;n2=23;TEMP=300"
	},
/area/ruins/lavaland/powered/generic)
"N" = (
/obj/structure/shuttle/engine/propulsion{
	dir = 8;
	icon_state = "propulsion"
	},
/turf/open/floor/plating/asteroid/basalt/lava_land_surface,
/area/ruins/lavaland/powered/generic)
"O" = (
/turf/closed/mineral/volcanic/lava_land_surface,
/area/ruins/lavaland/powered/generic)
"R" = (
/obj/structure/lattice,
/turf/open/floor/plating/asteroid/basalt/lava_land_surface,
/area/external/mining/lavaland/explored)
"U" = (
/turf/open/floor/mineral/plastitanium/red{
	initial_gas_mix = "o2=14;n2=23;TEMP=300"
	},
/area/external/mining/lavaland/explored)
"W" = (
/turf/open/floor/mineral/plastitanium/red{
	initial_gas_mix = "o2=14;n2=23;TEMP=300"
	},
/area/ruins/lavaland/powered/generic)
"X" = (
/obj/structure/closet/wardrobe/red{
	desc = "The Pilot won't be needing any of this....";
	name = "Pilots Belongings"
	},
/obj/item/ammo_box/c45,
/obj/item/tank/internals/emergency_oxygen/double,
/obj/item/toy/figure/secofficer,
/obj/item/tank/internals/oxygen/red,
/turf/open/floor/mineral/plastitanium/red{
	initial_gas_mix = "o2=14;n2=23;TEMP=300"
	},
/area/ruins/lavaland/powered/generic)
"Y" = (
/obj/item/shard{
	icon_state = "small"
	},
/turf/open/floor/plating/asteroid/basalt/lava_land_surface,
/area/external/mining/lavaland/explored)
"Z" = (
/turf/open/floor/mineral/plastitanium/red,
/area/ruins/lavaland/powered/generic)

(1,1,1) = {"
a
a
b
b
b
b
b
b
b
b
b
b
b
b
b
b
b
b
b
b
"}
(2,1,1) = {"
b
a
b
b
b
a
a
b
b
b
b
b
b
b
b
b
b
b
a
b
"}
(3,1,1) = {"
b
b
c
b
b
a
a
b
b
b
b
b
b
b
b
b
b
b
b
a
"}
(4,1,1) = {"
b
b
b
b
b
b
a
b
b
N
L
N
L
N
b
b
b
Y
b
b
"}
(5,1,1) = {"
b
b
a
a
a
b
b
b
b
L
L
L
L
L
b
b
b
G
b
b
"}
(6,1,1) = {"
b
b
a
a
a
b
b
L
N
L
j
n
u
L
N
L
b
b
z
b
"}
(7,1,1) = {"
b
b
b
b
b
b
b
b
L
L
k
o
k
L
L
b
b
B
A
b
"}
(8,1,1) = {"
a
b
b
b
b
b
b
a
a
L
k
v
k
L
b
b
B
B
b
b
"}
(9,1,1) = {"
b
b
b
d
b
b
b
a
a
L
k
Z
k
L
b
b
B
B
b
b
"}
(10,1,1) = {"
b
b
b
b
b
b
b
a
a
L
k
Z
k
L
b
b
b
b
a
a
"}
(11,1,1) = {"
a
b
b
b
b
b
b
a
a
L
L
q
L
L
b
b
b
b
a
a
"}
(12,1,1) = {"
a
b
b
b
b
b
b
b
b
L
U
U
U
R
b
b
b
b
a
a
"}
(13,1,1) = {"
b
b
b
a
b
b
b
a
b
r
U
t
U
R
b
b
b
c
a
a
"}
(14,1,1) = {"
b
a
a
b
b
a
a
a
a
r
U
U
U
U
b
b
b
b
a
a
"}
(15,1,1) = {"
b
b
b
a
a
a
a
a
a
L
L
l
L
L
b
b
b
b
a
a
"}
(16,1,1) = {"
b
b
b
a
a
a
a
a
a
L
W
M
O
L
b
b
b
b
a
a
"}
(17,1,1) = {"
b
b
b
a
a
a
a
a
a
L
X
W
O
L
b
b
b
b
a
a
"}
(18,1,1) = {"
b
b
b
b
b
a
a
a
a
a
a
a
L
a
a
b
a
a
a
a
"}
(19,1,1) = {"
b
b
b
b
b
a
a
a
a
a
a
a
a
b
b
b
a
a
a
a
"}
(20,1,1) = {"
b
b
b
b
b
a
a
a
a
a
a
a
a
b
b
b
b
b
a
a
"}
