//MAP CONVERTED BY dmm2tgm.py THIS HEADER COMMENT PREVENTS RECONVERSION, DO NOT REMOVE
"aH" = (
/turf/template_noop,
/area/template_noop)
"bw" = (
/obj/structure/stone_tile/block,
/obj/structure/stone_tile/block{
	dir = 1
	},
/turf/open/indestructible/boss,
/area/external/mining/lavaland/explored)
"by" = (
/obj/effect/decal/remains/robot,
/turf/open/indestructible/necropolis,
/area/external/mining/lavaland/explored)
"bJ" = (
/obj/structure/stone_tile/surrounding_tile{
	dir = 8
	},
/obj/structure/stone_tile/surrounding_tile{
	dir = 4
	},
/obj/structure/stone_tile/surrounding_tile,
/turf/open/indestructible/necropolis,
/area/external/mining/lavaland/explored)
"bO" = (
/obj/structure/stone_tile/surrounding,
/obj/structure/stone_tile/center,
/turf/open/lava/smooth/lava_land_surface,
/area/external/mining/lavaland/explored)
"cc" = (
/obj/effect/decal/remains/human,
/turf/open/floor/plating/lavaland_baseturf{
	icon_state = "panelscorched"
	},
/area/external/mining/lavaland/explored)
"cw" = (
/obj/effect/decal/remains/plasma,
/turf/open/floor/plating/asteroid/basalt/lava_land_surface,
/area/external/mining/lavaland/explored)
"dS" = (
/obj/effect/decal/remains/human,
/turf/open/floor/plating/lavaland_baseturf{
	icon_state = "platingdmg3"
	},
/area/external/mining/lavaland/explored)
"eb" = (
/obj/effect/mob_spawn/human/corpse/nanotrasensoldier,
/turf/open/floor/plating/lavaland_baseturf{
	icon_state = "platingdmg3"
	},
/area/external/mining/lavaland/explored)
"fg" = (
/turf/open/floor/plating/asteroid/basalt/lava_land_surface,
/area/external/mining/lavaland/explored)
"ge" = (
/obj/structure/spawner/lavaland/goliath,
/turf/open/floor/plating/asteroid/basalt/lava_land_surface,
/area/external/mining/lavaland/explored)
"gI" = (
/obj/structure/stone_tile/block,
/turf/open/floor/plating/asteroid/basalt/lava_land_surface,
/area/external/mining/lavaland/explored)
"iK" = (
/obj/effect/mapping_helpers/no_lava,
/turf/open/floor/plating/asteroid/basalt/lava_land_surface,
/area/external/mining/lavaland/explored)
"jp" = (
/turf/open/lava/smooth/lava_land_surface,
/area/external/mining/lavaland/explored)
"jU" = (
/obj/structure/fence/cut,
/turf/open/floor/plating/asteroid/basalt/lava_land_surface,
/area/external/mining/lavaland/explored)
"kY" = (
/obj/structure/stone_tile/surrounding_tile,
/obj/structure/stone_tile/surrounding_tile{
	dir = 4
	},
/turf/open/indestructible/necropolis,
/area/external/mining/lavaland/explored)
"lj" = (
/obj/structure/stone_tile/block,
/obj/structure/stone_tile/block{
	dir = 1
	},
/turf/open/floor/plating/asteroid/basalt/lava_land_surface,
/area/external/mining/lavaland/explored)
"lA" = (
/obj/structure/stone_tile/slab,
/turf/open/indestructible/necropolis,
/area/external/mining/lavaland/explored)
"lW" = (
/obj/structure/sign/warning/explosives,
/turf/closed/wall/mineral/titanium/survival,
/area/external/mining/lavaland/explored)
"np" = (
/turf/closed/mineral/gibtonite/volcanic/harder,
/area/external/mining/lavaland/explored)
"nL" = (
/obj/structure/stone_tile/surrounding_tile{
	dir = 8
	},
/turf/open/indestructible/necropolis,
/area/external/mining/lavaland/explored)
"nR" = (
/obj/structure/stone_tile{
	dir = 4
	},
/obj/structure/stone_tile{
	dir = 1
	},
/obj/structure/stone_tile{
	dir = 8
	},
/obj/structure/stone_tile,
/turf/open/lava/smooth/lava_land_surface,
/area/external/mining/lavaland/explored)
"nZ" = (
/turf/closed/indestructible/riveted/boss,
/area/external/mining/lavaland/explored)
"ot" = (
/obj/structure/stone_tile/slab,
/turf/open/lava/smooth/lava_land_surface,
/area/external/mining/lavaland/explored)
"ov" = (
/obj/effect/mob_spawn/human/corpse/nanotrasensoldier,
/turf/open/floor/plating/lavaland_baseturf{
	icon_state = "panelscorched"
	},
/area/external/mining/lavaland/explored)
"ox" = (
/obj/structure/fence/cut/medium{
	dir = 4
	},
/turf/open/floor/plating/asteroid/basalt/lava_land_surface,
/area/external/mining/lavaland/explored)
"oE" = (
/turf/closed/mineral/gem/volcanic/hard,
/area/external/mining/lavaland/explored)
"oQ" = (
/obj/structure/sign/warning/explosives/alt,
/turf/closed/wall/mineral/titanium/survival,
/area/external/mining/lavaland/explored)
"pF" = (
/obj/structure/stone_tile/block,
/obj/structure/stone_tile{
	dir = 1
	},
/obj/structure/stone_tile{
	dir = 4
	},
/turf/open/indestructible/boss,
/area/external/mining/lavaland/explored)
"pJ" = (
/obj/structure/stone_tile/block,
/turf/open/indestructible/necropolis,
/area/external/mining/lavaland/explored)
"qh" = (
/obj/structure/stone_tile/surrounding,
/turf/open/lava/smooth/lava_land_surface,
/area/external/mining/lavaland/explored)
"qj" = (
/obj/item/stack/ore/plasma,
/obj/structure/stone_tile/surrounding_tile{
	dir = 8
	},
/turf/open/floor/plating/asteroid/basalt/lava_land_surface,
/area/external/mining/lavaland/explored)
"qm" = (
/turf/closed/mineral/plasma/volcanic,
/area/external/mining/lavaland/explored)
"qs" = (
/obj/effect/decal/remains/robot,
/obj/structure/stone_tile/surrounding_tile,
/turf/open/floor/plating/asteroid/basalt/lava_land_surface,
/area/external/mining/lavaland/explored)
"qA" = (
/obj/structure/fence/door{
	dir = 8
	},
/turf/open/floor/plating/asteroid/basalt/lava_land_surface,
/area/external/mining/lavaland/explored)
"qG" = (
/turf/open/indestructible/necropolis,
/area/external/mining/lavaland/explored)
"rw" = (
/obj/structure/marker_beacon,
/obj/structure/stone_tile/block,
/obj/structure/stone_tile/block{
	dir = 1
	},
/turf/open/indestructible/necropolis,
/area/external/mining/lavaland/explored)
"rO" = (
/obj/structure/fence/door{
	dir = 4
	},
/turf/open/floor/plating/asteroid/basalt/lava_land_surface,
/area/external/mining/lavaland/explored)
"rP" = (
/obj/structure/marker_beacon,
/obj/structure/stone_tile/block{
	dir = 8
	},
/obj/structure/stone_tile/block{
	dir = 4
	},
/turf/open/indestructible/boss,
/area/external/mining/lavaland/explored)
"tr" = (
/obj/structure/stone_tile/block{
	dir = 1
	},
/obj/structure/stone_tile{
	dir = 8
	},
/turf/open/indestructible/necropolis,
/area/external/mining/lavaland/explored)
"tv" = (
/obj/structure/stone_tile/surrounding_tile,
/turf/open/indestructible/necropolis,
/area/external/mining/lavaland/explored)
"tH" = (
/obj/structure/stone_tile,
/obj/structure/stone_tile{
	dir = 4
	},
/obj/structure/stone_tile{
	dir = 8
	},
/obj/structure/stone_tile{
	dir = 1
	},
/turf/open/indestructible/boss,
/area/external/mining/lavaland/explored)
"tO" = (
/obj/effect/decal/remains/robot,
/obj/structure/stone_tile/slab,
/turf/open/indestructible/necropolis,
/area/external/mining/lavaland/explored)
"tW" = (
/obj/structure/stone_tile/block{
	dir = 4
	},
/turf/open/floor/plating/asteroid/basalt/lava_land_surface,
/area/external/mining/lavaland/explored)
"uC" = (
/turf/closed/mineral/gibtonite/volcanic,
/area/external/mining/lavaland/explored)
"uE" = (
/turf/closed/mineral/random/volcanic/hard,
/area/external/mining/lavaland/explored)
"vo" = (
/obj/structure/stone_tile/block{
	dir = 8
	},
/turf/open/floor/plating/asteroid/basalt/lava_land_surface,
/area/external/mining/lavaland/explored)
"vp" = (
/obj/item/stack/ore/plasma,
/obj/effect/decal/remains/plasma,
/turf/open/floor/plating/asteroid/basalt/lava_land_surface,
/area/external/mining/lavaland/explored)
"vt" = (
/obj/structure/stone_tile/block,
/obj/structure/stone_tile{
	dir = 1
	},
/turf/open/indestructible/necropolis,
/area/external/mining/lavaland/explored)
"wH" = (
/obj/item/stack/ore/plasma,
/obj/structure/marker_beacon,
/turf/open/indestructible/necropolis,
/area/external/mining/lavaland/explored)
"xv" = (
/obj/item/stack/ore/plasma,
/obj/structure/stone_tile/surrounding_tile{
	dir = 4
	},
/turf/open/indestructible/necropolis,
/area/external/mining/lavaland/explored)
"xU" = (
/obj/structure/stone_tile,
/obj/structure/stone_tile{
	dir = 8
	},
/obj/structure/stone_tile{
	dir = 4
	},
/obj/structure/stone_tile{
	dir = 1
	},
/turf/open/indestructible/boss,
/area/external/mining/lavaland/explored)
"yj" = (
/obj/structure/fence/door,
/turf/open/floor/plating/asteroid/basalt/lava_land_surface,
/area/external/mining/lavaland/explored)
"yD" = (
/obj/effect/decal/remains/human,
/turf/open/indestructible/necropolis,
/area/external/mining/lavaland/explored)
"zU" = (
/obj/item/clothing/neck/cloak/herald_cloak,
/mob/living/simple_animal/hostile/asteroid/elite/herald{
	faction = list("mining")
	},
/obj/structure/closet/crate/necropolis/tendril{
	anchored = 1
	},
/obj/structure/stone_tile/surrounding,
/obj/structure/stone_tile/center,
/turf/open/lava/smooth/lava_land_surface,
/area/external/mining/lavaland/explored)
"zV" = (
/obj/structure/stone_tile/surrounding_tile{
	dir = 4
	},
/obj/structure/stone_tile/surrounding_tile{
	dir = 1
	},
/obj/structure/stone_tile/surrounding_tile{
	dir = 8
	},
/obj/structure/stone_tile/center,
/turf/open/indestructible/necropolis,
/area/external/mining/lavaland/explored)
"Ab" = (
/turf/open/floor/plating/lavaland_baseturf{
	icon_state = "platingdmg3"
	},
/area/external/mining/lavaland/explored)
"Bb" = (
/obj/structure/stone_tile,
/obj/structure/stone_tile{
	dir = 1
	},
/obj/structure/stone_tile{
	dir = 8
	},
/obj/structure/stone_tile{
	dir = 4
	},
/turf/open/lava/smooth/lava_land_surface,
/area/external/mining/lavaland/explored)
"Bm" = (
/obj/structure/fence/cut/medium,
/turf/open/floor/plating/asteroid/basalt/lava_land_surface,
/area/external/mining/lavaland/explored)
"Cq" = (
/obj/structure/fence/post,
/turf/open/floor/plating/asteroid/basalt/lava_land_surface,
/area/external/mining/lavaland/explored)
"CI" = (
/turf/closed/mineral/diamond/volcanic/harder,
/area/external/mining/lavaland/explored)
"Di" = (
/turf/closed/mineral/bananium/volcanic/harder,
/area/external/mining/lavaland/explored)
"EO" = (
/obj/structure/stone_tile,
/obj/structure/stone_tile{
	dir = 4
	},
/obj/structure/stone_tile{
	dir = 1
	},
/obj/structure/stone_tile{
	dir = 8
	},
/turf/open/indestructible/boss,
/area/external/mining/lavaland/explored)
"Fj" = (
/turf/closed/wall/mineral/titanium/survival,
/area/external/mining/lavaland/explored)
"Fn" = (
/obj/structure/marker_beacon,
/obj/effect/mapping_helpers/no_lava,
/turf/open/floor/plating/asteroid/basalt/lava_land_surface,
/area/external/mining/lavaland/explored)
"GH" = (
/obj/item/stack/ore/plasma,
/turf/open/floor/plating/asteroid/basalt/lava_land_surface,
/area/external/mining/lavaland/explored)
"Hm" = (
/obj/structure/marker_beacon,
/turf/open/floor/plating/lavaland_baseturf{
	icon_state = "platingdmg3"
	},
/area/external/mining/lavaland/explored)
"Hq" = (
/obj/structure/stone_tile/block{
	dir = 8
	},
/turf/open/indestructible/necropolis,
/area/external/mining/lavaland/explored)
"In" = (
/turf/closed/mineral/bananium/volcanic/hard,
/area/external/mining/lavaland/explored)
"JE" = (
/obj/item/stack/ore/plasma,
/obj/structure/stone_tile/surrounding_tile{
	dir = 8
	},
/turf/open/indestructible/necropolis,
/area/external/mining/lavaland/explored)
"Kc" = (
/obj/structure/stone_tile/surrounding_tile,
/obj/structure/stone_tile/surrounding_tile{
	dir = 1
	},
/obj/structure/stone_tile/surrounding_tile{
	dir = 8
	},
/obj/structure/stone_tile/center,
/turf/open/indestructible/necropolis,
/area/external/mining/lavaland/explored)
"KW" = (
/obj/item/stack/ore/plasma,
/obj/structure/stone_tile/surrounding_tile{
	dir = 1
	},
/turf/open/floor/plating/asteroid/basalt/lava_land_surface,
/area/external/mining/lavaland/explored)
"Lf" = (
/obj/structure/stone_tile/surrounding_tile{
	dir = 1
	},
/obj/structure/stone_tile/surrounding_tile,
/turf/open/indestructible/necropolis,
/area/external/mining/lavaland/explored)
"Ly" = (
/turf/closed/mineral/plasma/volcanic/hard,
/area/external/mining/lavaland/explored)
"LR" = (
/turf/open/floor/pod/dark,
/area/external/mining/lavaland/explored)
"Mm" = (
/turf/open/chasm,
/area/external/mining/lavaland/explored)
"Ne" = (
/obj/structure/fence/cut/large{
	dir = 4
	},
/turf/open/floor/plating/asteroid/basalt/lava_land_surface,
/area/external/mining/lavaland/explored)
"Np" = (
/obj/structure/sign/mining,
/turf/closed/wall/mineral/titanium/survival,
/area/external/mining/lavaland/explored)
"NM" = (
/obj/structure/stone_tile/block{
	dir = 8
	},
/obj/structure/stone_tile{
	dir = 1
	},
/turf/open/indestructible/necropolis,
/area/external/mining/lavaland/explored)
"Oy" = (
/obj/structure/stone_tile/surrounding_tile{
	dir = 8
	},
/obj/structure/stone_tile/surrounding_tile{
	dir = 4
	},
/turf/open/indestructible/necropolis,
/area/external/mining/lavaland/explored)
"Pq" = (
/obj/item/stack/ore/plasma,
/obj/structure/stone_tile/surrounding_tile,
/turf/open/indestructible/necropolis,
/area/external/mining/lavaland/explored)
"QH" = (
/obj/item/stack/ore/plasma,
/obj/structure/stone_tile/surrounding_tile{
	dir = 1
	},
/turf/open/indestructible/necropolis,
/area/external/mining/lavaland/explored)
"QN" = (
/obj/structure/stone_tile/block{
	dir = 1
	},
/obj/structure/stone_tile/block,
/turf/open/floor/plating/asteroid/basalt/lava_land_surface,
/area/external/mining/lavaland/explored)
"QT" = (
/obj/structure/stone_tile/block{
	dir = 1
	},
/obj/structure/stone_tile,
/obj/structure/stone_tile{
	dir = 8
	},
/turf/open/indestructible/boss,
/area/external/mining/lavaland/explored)
"RM" = (
/obj/structure/stone_tile/surrounding_tile,
/turf/open/floor/plating/asteroid/basalt/lava_land_surface,
/area/external/mining/lavaland/explored)
"RN" = (
/obj/structure/stone_tile/block{
	dir = 4
	},
/obj/structure/stone_tile{
	dir = 8
	},
/turf/open/indestructible/necropolis,
/area/external/mining/lavaland/explored)
"Sg" = (
/obj/structure/stone_tile/block{
	dir = 1
	},
/turf/open/indestructible/necropolis,
/area/external/mining/lavaland/explored)
"Sp" = (
/obj/structure/marker_beacon,
/turf/open/floor/plating/asteroid/basalt/lava_land_surface,
/area/external/mining/lavaland/explored)
"SB" = (
/turf/closed/mineral/diamond/volcanic/hard,
/area/external/mining/lavaland/explored)
"SE" = (
/mob/living/simple_animal/hostile/asteroid/hivelord/legion/advanced,
/turf/open/floor/plating/asteroid/basalt/lava_land_surface,
/area/external/mining/lavaland/explored)
"SH" = (
/turf/open/floor/pod/light,
/area/external/mining/lavaland/explored)
"SN" = (
/obj/structure/fence/cut{
	dir = 4
	},
/turf/open/floor/plating/asteroid/basalt/lava_land_surface,
/area/external/mining/lavaland/explored)
"SX" = (
/turf/closed/mineral/gem/volcanic/harder,
/area/external/mining/lavaland/explored)
"Tf" = (
/obj/effect/decal/remains/xeno,
/turf/open/floor/plating/asteroid/basalt/lava_land_surface,
/area/external/mining/lavaland/explored)
"TH" = (
/obj/structure/stone_tile/surrounding_tile{
	dir = 4
	},
/turf/open/indestructible/necropolis,
/area/external/mining/lavaland/explored)
"TP" = (
/obj/structure/stone_tile/surrounding_tile{
	dir = 1
	},
/turf/open/indestructible/necropolis,
/area/external/mining/lavaland/explored)
"Ui" = (
/obj/structure/fence/cut/large,
/turf/open/floor/plating/asteroid/basalt/lava_land_surface,
/area/external/mining/lavaland/explored)
"Uy" = (
/obj/effect/decal/remains/human,
/turf/open/floor/plating/asteroid/basalt/lava_land_surface,
/area/external/mining/lavaland/explored)
"UU" = (
/turf/open/floor/plating/lavaland_baseturf{
	icon_state = "panelscorched"
	},
/area/external/mining/lavaland/explored)
"Vc" = (
/obj/structure/stone_tile{
	dir = 4
	},
/obj/structure/stone_tile{
	dir = 8
	},
/obj/structure/stone_tile,
/obj/structure/stone_tile{
	dir = 1
	},
/turf/open/lava/smooth/lava_land_surface,
/area/external/mining/lavaland/explored)
"Wm" = (
/obj/structure/stone_tile/block{
	dir = 1
	},
/turf/open/floor/plating/asteroid/basalt/lava_land_surface,
/area/external/mining/lavaland/explored)
"XF" = (
/obj/structure/stone_tile/surrounding_tile{
	dir = 1
	},
/obj/structure/stone_tile/surrounding_tile{
	dir = 4
	},
/obj/structure/stone_tile/surrounding_tile,
/turf/open/indestructible/necropolis,
/area/external/mining/lavaland/explored)
"XX" = (
/obj/structure/stone_tile/block{
	dir = 4
	},
/turf/open/indestructible/necropolis,
/area/external/mining/lavaland/explored)
"Yc" = (
/turf/closed/mineral/gibtonite/volcanic/hard,
/area/external/mining/lavaland/explored)
"Yo" = (
/obj/structure/stone_tile/block,
/obj/structure/stone_tile/block{
	dir = 1
	},
/turf/open/indestructible/necropolis,
/area/external/mining/lavaland/explored)
"YL" = (
/obj/structure/marker_beacon,
/turf/open/floor/plating/lavaland_baseturf{
	icon_state = "panelscorched"
	},
/area/external/mining/lavaland/explored)
"Zu" = (
/obj/structure/stone_tile/surrounding_tile{
	dir = 4
	},
/turf/open/floor/plating/asteroid/basalt/lava_land_surface,
/area/external/mining/lavaland/explored)
"Zw" = (
/obj/structure/stone_tile,
/obj/structure/stone_tile{
	dir = 8
	},
/obj/structure/stone_tile{
	dir = 1
	},
/obj/structure/stone_tile{
	dir = 4
	},
/turf/open/lava/smooth/lava_land_surface,
/area/external/mining/lavaland/explored)

(1,1,1) = {"
aH
aH
aH
aH
aH
aH
aH
aH
aH
aH
aH
aH
aH
iK
iK
Fn
iK
aH
aH
aH
aH
aH
aH
aH
aH
aH
aH
aH
aH
"}
(2,1,1) = {"
aH
aH
aH
aH
aH
aH
aH
uE
uE
aH
aH
aH
aH
iK
iK
iK
iK
uE
aH
aH
aH
uE
uE
uE
aH
aH
aH
aH
aH
"}
(3,1,1) = {"
aH
aH
aH
aH
uE
uE
uE
uE
uE
uE
uE
aH
aH
iK
Fn
iK
iK
aH
uE
uE
uE
uE
uE
aH
aH
aH
aH
aH
aH
"}
(4,1,1) = {"
aH
aH
aH
uE
uE
uE
uE
uE
uE
uE
Fn
iK
iK
iK
iK
iK
iK
iK
Sp
uE
uE
uE
uE
uE
aH
aH
aH
aH
aH
"}
(5,1,1) = {"
aH
aH
uE
uE
uE
uE
Ly
Ly
Ly
Ly
Ly
Bm
qA
Cq
In
SB
jU
Ui
Ly
Ly
Ly
Ly
Ly
uE
uE
aH
aH
aH
aH
"}
(6,1,1) = {"
aH
aH
uE
uE
uE
Ly
Ly
jp
jp
jp
aH
aH
fg
In
Yc
Di
CI
fg
jp
jp
jp
jp
Ly
Ly
uE
uE
aH
aH
aH
"}
(7,1,1) = {"
aH
aH
uE
uE
Ly
Ly
Yc
qm
qm
aH
aH
aH
fg
fg
aH
aH
fg
fg
jp
jp
qm
qm
Yc
Ly
Ly
uE
uE
aH
aH
"}
(8,1,1) = {"
aH
uE
uE
uE
Ly
jp
qm
qm
qm
aH
aH
aH
aH
Sp
GH
fg
fg
aH
aH
aH
qm
qm
qm
jp
Ly
uE
uE
aH
aH
"}
(9,1,1) = {"
aH
uE
uE
uE
Ly
jp
qm
qm
aH
aH
fg
xv
Hq
fg
jp
cw
Hq
JE
Ab
SH
ov
qm
qm
jp
Ly
uE
uE
aH
aH
"}
(10,1,1) = {"
aH
aH
uE
uE
Ly
jp
aH
aH
aH
fg
fg
fg
Yo
jp
jp
jp
rw
aH
eb
Np
YL
fg
fg
jp
Ly
uE
uE
uE
aH
"}
(11,1,1) = {"
aH
aH
uE
iK
Ly
aH
aH
qm
jp
fg
fg
TP
lA
aH
nZ
vo
tO
tv
UU
YL
dS
qm
fg
fg
Ly
uE
uE
aH
uE
"}
(12,1,1) = {"
aH
aH
aH
iK
SN
fg
aH
qm
qm
aH
np
qG
qG
jp
jp
ot
qG
qG
np
aH
qm
qm
fg
Sp
oE
uE
uE
uE
uE
"}
(13,1,1) = {"
uE
aH
Fn
iK
ox
fg
Mm
Mm
qm
qG
Hq
jp
qG
Sg
ot
tv
qG
jp
qG
Hq
qm
ge
fg
fg
jp
uE
uE
uE
uE
"}
(14,1,1) = {"
uE
uE
iK
iK
SN
fg
Mm
Mm
qG
jp
bO
jp
jp
yD
qG
wH
jp
jp
jp
qh
pJ
fg
fg
jp
jp
aH
uE
aH
uE
"}
(15,1,1) = {"
uE
uE
iK
iK
SN
fg
TH
Hq
nL
qG
XX
jp
fg
EO
uC
tH
QT
qh
vt
RN
kY
Hq
nL
jp
Fj
iK
aH
aH
uE
"}
(16,1,1) = {"
uE
uE
iK
iK
oQ
fg
fg
ot
nZ
GH
qG
gI
SE
TH
Oy
nL
fg
Wm
qG
gI
nZ
ot
cw
fg
ox
iK
iK
aH
aH
"}
(17,1,1) = {"
aH
uE
iK
iK
SN
fg
Sp
bO
fg
aH
bw
qs
qG
zV
Vc
bJ
qG
KW
bw
RM
fg
bO
aH
fg
Ne
iK
Fn
aH
aH
"}
(18,1,1) = {"
aH
uE
iK
iK
yj
fg
aH
QN
fg
jp
rP
SX
qG
nR
zU
Zw
qG
SX
rP
jp
fg
lj
aH
fg
yj
iK
iK
uE
aH
"}
(19,1,1) = {"
aH
aH
Fn
iK
ox
fg
aH
bO
fg
Zu
bw
qj
qG
XF
Bb
Kc
qG
fg
bw
aH
fg
bO
Sp
fg
SN
iK
iK
uE
aH
"}
(20,1,1) = {"
aH
aH
iK
iK
Ne
fg
Tf
ot
nZ
Wm
qG
gI
fg
TP
Lf
tv
SE
cw
qG
vp
nZ
ot
fg
fg
lW
iK
iK
uE
uE
"}
(21,1,1) = {"
uE
aH
aH
iK
Fj
jp
TP
XX
kY
NM
tr
qh
pF
xU
uC
xU
fg
jp
Hq
qG
TP
XX
tv
fg
SN
iK
iK
uE
uE
"}
(22,1,1) = {"
uE
aH
uE
aH
jp
jp
fg
fg
Sg
qh
jp
jp
jp
wH
qG
qG
jp
jp
bO
jp
qG
Mm
Mm
fg
SN
iK
iK
uE
uE
"}
(23,1,1) = {"
uE
uE
uE
uE
jp
fg
fg
ge
qm
XX
qG
jp
qG
TH
ot
pJ
qG
jp
XX
qG
qm
Mm
Mm
fg
Ne
iK
Fn
aH
uE
"}
(24,1,1) = {"
uE
uE
uE
uE
oE
Sp
fg
qm
qm
aH
np
qG
qG
ot
jp
jp
qG
by
np
aH
qm
qm
aH
fg
SN
iK
iK
aH
aH
"}
(25,1,1) = {"
uE
aH
uE
uE
Ly
fg
fg
qm
cc
Hm
UU
TH
lA
tW
nZ
aH
lA
nL
fg
fg
jp
qm
aH
aH
Ly
iK
uE
aH
aH
"}
(26,1,1) = {"
aH
uE
uE
uE
Ly
jp
fg
fg
YL
Np
eb
aH
rw
jp
jp
jp
Yo
fg
fg
fg
aH
aH
aH
jp
Ly
uE
uE
aH
aH
"}
(27,1,1) = {"
aH
aH
uE
uE
Ly
jp
qm
qm
eb
LR
UU
QH
XX
fg
jp
Uy
XX
Pq
fg
aH
aH
qm
qm
jp
Ly
uE
uE
uE
aH
"}
(28,1,1) = {"
aH
aH
uE
uE
Ly
jp
qm
qm
qm
aH
aH
aH
fg
fg
GH
Sp
aH
aH
aH
aH
qm
qm
qm
jp
Ly
uE
uE
uE
aH
"}
(29,1,1) = {"
aH
aH
uE
uE
Ly
Ly
Yc
qm
qm
jp
jp
fg
fg
aH
aH
fg
fg
aH
aH
aH
qm
qm
Yc
Ly
Ly
uE
uE
aH
aH
"}
(30,1,1) = {"
aH
aH
uE
uE
uE
Ly
Ly
jp
jp
jp
jp
fg
CI
Di
Yc
In
fg
aH
aH
jp
jp
jp
Ly
Ly
uE
uE
uE
aH
aH
"}
(31,1,1) = {"
aH
aH
uE
uE
uE
uE
Ly
Ly
Ly
Ly
Ly
jU
jU
SB
In
jU
rO
Bm
Ly
Ly
Ly
Ly
Ly
uE
uE
uE
uE
aH
aH
"}
(32,1,1) = {"
aH
aH
aH
uE
uE
uE
uE
uE
uE
uE
Fn
iK
iK
iK
iK
iK
iK
iK
Sp
uE
uE
uE
uE
uE
uE
uE
aH
aH
aH
"}
(33,1,1) = {"
aH
aH
aH
aH
uE
uE
uE
uE
uE
uE
uE
aH
iK
Fn
iK
iK
aH
aH
uE
uE
uE
uE
uE
uE
uE
aH
aH
aH
aH
"}
(34,1,1) = {"
aH
aH
aH
uE
uE
uE
aH
aH
aH
aH
aH
uE
iK
iK
iK
iK
aH
aH
aH
aH
uE
uE
aH
aH
aH
aH
aH
aH
aH
"}
(35,1,1) = {"
aH
aH
aH
aH
aH
aH
aH
aH
aH
aH
aH
aH
iK
iK
Fn
iK
aH
aH
aH
aH
aH
aH
aH
aH
aH
aH
aH
aH
aH
"}
