//MAP CONVERTED BY dmm2tgm.py THIS HEADER COMMENT PREVENTS RECONVERSION, DO NOT REMOVE
"b" = (
/obj/structure/stone_tile/block{
	dir = 4
	},
/obj/structure/stone_tile{
	dir = 4
	},
/turf/open/floor/plating/asteroid/basalt/lava_land_surface,
/area/external/mining/lavaland/explored)
"d" = (
/obj/structure/railing{
	dir = 8
	},
/turf/open/floor/plating/asteroid/basalt/lava_land_surface,
/area/external/mining/lavaland/explored)
"e" = (
/obj/structure/stone_tile/cracked,
/turf/open/floor/plating/asteroid/basalt/lava_land_surface,
/area/external/mining/lavaland/explored)
"f" = (
/obj/structure/stone_tile{
	dir = 1
	},
/obj/structure/stone_tile/cracked{
	dir = 8
	},
/turf/open/floor/plating/asteroid/basalt/lava_land_surface,
/area/external/mining/lavaland/explored)
"g" = (
/obj/structure/stone_tile/block{
	dir = 8
	},
/obj/structure/stone_tile/block/cracked{
	dir = 4
	},
/turf/open/floor/plating/asteroid/basalt/lava_land_surface,
/area/external/mining/lavaland/explored)
"i" = (
/obj/structure/stone_tile{
	dir = 1
	},
/turf/open/floor/plating/asteroid/basalt/lava_land_surface,
/area/external/mining/lavaland/explored)
"j" = (
/obj/structure/katana_grave/basalt,
/turf/open/floor/plating/asteroid/basalt/lava_land_surface,
/area/external/mining/lavaland/explored)
"n" = (
/obj/structure/stone_tile/block{
	dir = 1
	},
/obj/structure/stone_tile{
	dir = 8
	},
/turf/open/floor/plating/asteroid/basalt/lava_land_surface,
/area/external/mining/lavaland/explored)
"o" = (
/obj/structure/stone_tile/block{
	dir = 1
	},
/turf/open/floor/plating/asteroid/basalt/lava_land_surface,
/area/external/mining/lavaland/explored)
"q" = (
/obj/structure/stone_tile/slab/cracked,
/turf/open/floor/plating/asteroid/basalt/lava_land_surface,
/area/external/mining/lavaland/explored)
"t" = (
/obj/structure/stone_tile{
	dir = 8
	},
/obj/structure/stone_tile,
/obj/structure/stone_tile/cracked{
	dir = 1
	},
/turf/open/floor/plating/asteroid/basalt/lava_land_surface,
/area/external/mining/lavaland/explored)
"v" = (
/obj/structure/railing{
	dir = 10
	},
/turf/open/floor/plating/asteroid/basalt/lava_land_surface,
/area/external/mining/lavaland/explored)
"x" = (
/turf/closed/wall/mineral/iron,
/area/external/mining/lavaland/explored)
"y" = (
/obj/structure/railing{
	dir = 4
	},
/turf/open/floor/plating/asteroid/basalt/lava_land_surface,
/area/external/mining/lavaland/explored)
"z" = (
/obj/structure/stone_tile{
	dir = 4
	},
/turf/open/floor/plating/asteroid/basalt/lava_land_surface,
/area/external/mining/lavaland/explored)
"A" = (
/turf/template_noop,
/area/template_noop)
"B" = (
/turf/open/floor/plating/asteroid/basalt/lava_land_surface,
/area/external/mining/lavaland/explored)
"C" = (
/obj/structure/flora/rock/pile,
/turf/open/floor/plating/asteroid/basalt/lava_land_surface,
/area/external/mining/lavaland/explored)
"D" = (
/obj/structure/stone_tile/block{
	dir = 4
	},
/turf/open/floor/plating/asteroid/basalt/lava_land_surface,
/area/external/mining/lavaland/explored)
"E" = (
/obj/structure/stone_tile/block{
	dir = 1
	},
/obj/structure/stone_tile,
/turf/open/floor/plating/asteroid/basalt/lava_land_surface,
/area/external/mining/lavaland/explored)
"G" = (
/obj/structure/stone_tile/block{
	dir = 1
	},
/obj/structure/stone_tile,
/obj/structure/stone_tile{
	dir = 8
	},
/turf/open/floor/plating/asteroid/basalt/lava_land_surface,
/area/external/mining/lavaland/explored)
"H" = (
/obj/structure/stone_tile{
	dir = 8
	},
/obj/structure/stone_tile/block{
	dir = 4
	},
/turf/open/floor/plating/asteroid/basalt/lava_land_surface,
/area/external/mining/lavaland/explored)
"I" = (
/obj/structure/stone_tile{
	dir = 4
	},
/obj/structure/stone_tile{
	dir = 1
	},
/obj/structure/stone_tile,
/turf/open/floor/plating/asteroid/basalt/lava_land_surface,
/area/external/mining/lavaland/explored)
"M" = (
/obj/structure/railing{
	dir = 6
	},
/turf/open/floor/plating/asteroid/basalt/lava_land_surface,
/area/external/mining/lavaland/explored)
"O" = (
/obj/structure/stone_tile{
	dir = 4
	},
/obj/structure/stone_tile/cracked,
/turf/open/floor/plating/asteroid/basalt/lava_land_surface,
/area/external/mining/lavaland/explored)
"R" = (
/obj/structure/stone_tile{
	dir = 8
	},
/obj/structure/stone_tile/block/cracked{
	dir = 4
	},
/turf/open/floor/plating/asteroid/basalt/lava_land_surface,
/area/external/mining/lavaland/explored)
"T" = (
/obj/structure/stone_tile/block{
	dir = 4
	},
/obj/structure/stone_tile/block/cracked{
	dir = 8
	},
/turf/open/floor/plating/asteroid/basalt/lava_land_surface,
/area/external/mining/lavaland/explored)
"V" = (
/obj/structure/stone_tile/block{
	dir = 8
	},
/obj/structure/stone_tile/cracked{
	dir = 1
	},
/obj/structure/stone_tile,
/turf/open/floor/plating/asteroid/basalt/lava_land_surface,
/area/external/mining/lavaland/explored)
"W" = (
/obj/structure/stone_tile,
/turf/open/floor/plating/asteroid/basalt/lava_land_surface,
/area/external/mining/lavaland/explored)
"Y" = (
/obj/structure/fluff/grave,
/turf/open/floor/plating/asteroid/basalt/lava_land_surface,
/area/external/mining/lavaland/explored)

(1,1,1) = {"
A
A
A
A
A
A
A
W
B
A
A
A
A
A
A
"}
(2,1,1) = {"
A
A
A
B
A
A
B
z
B
A
A
A
A
A
A
"}
(3,1,1) = {"
A
A
x
B
x
x
x
T
x
x
x
x
x
A
A
"}
(4,1,1) = {"
A
A
x
B
B
B
B
G
B
B
B
B
B
B
A
"}
(5,1,1) = {"
A
A
x
B
Y
B
B
V
B
Y
B
B
x
B
A
"}
(6,1,1) = {"
A
A
x
B
B
B
Y
b
B
B
B
B
x
B
B
"}
(7,1,1) = {"
A
A
x
d
d
v
B
R
B
B
Y
B
C
B
B
"}
(8,1,1) = {"
A
A
x
B
j
B
o
q
I
g
t
D
n
f
z
"}
(9,1,1) = {"
A
A
x
y
y
M
B
b
B
Y
B
B
B
B
B
"}
(10,1,1) = {"
A
A
x
B
B
B
Y
O
B
B
B
B
x
B
A
"}
(11,1,1) = {"
A
B
C
B
Y
B
B
E
Y
B
Y
B
x
A
A
"}
(12,1,1) = {"
A
A
x
B
B
B
B
H
B
B
B
B
x
A
A
"}
(13,1,1) = {"
A
A
x
x
x
x
x
D
x
x
x
B
x
B
A
"}
(14,1,1) = {"
A
A
A
A
A
A
B
e
B
A
A
B
A
B
A
"}
(15,1,1) = {"
A
A
A
A
A
A
B
i
A
A
A
A
A
A
A
"}
