//MAP CONVERTED BY dmm2tgm.py THIS HEADER COMMENT PREVENTS RECONVERSION, DO NOT REMOVE
"aa" = (
/turf/template_noop,
/area/external/mining/lavaland/explored)
"ab" = (
/turf/open/lava/smooth/lava_land_surface,
/area/external/mining/lavaland/explored)
"ac" = (
/turf/closed/mineral/volcanic,
/area/external/mining/lavaland/explored)
"ad" = (
/obj/machinery/porta_turret/syndicate/energy/raven{
	armor = list("melee" = 90, "bullet" = 70, "laser" = 70, "energy" = 50, "bomb" = 100, "bio" = 0, "rad" = 0, "fire" = 90, "acid" = 90);
	desc = "A Raven-Class laser turret repurposed by the Russians for the defense of their numerous Bunkers. This turret appears to have anti-explosive plating.";
	faction = list("russian");
	name = "Russian Defense Turret MK-II"
	},
/turf/closed/wall/r_wall,
/area/ruins/lavaland/unpowered/russianbunker)
"ae" = (
/obj/structure/bed,
/obj/item/bedsheet/red,
/mob/living/simple_animal/hostile/russian/ranged/mosin,
/turf/open/floor/wood,
/area/ruins/lavaland/unpowered/russianbunker)
"af" = (
/obj/structure/dresser,
/turf/open/floor/wood,
/area/ruins/lavaland/unpowered/russianbunker)
"ag" = (
/turf/open/floor/wood,
/area/ruins/lavaland/unpowered/russianbunker)
"ah" = (
/obj/machinery/light{
	dir = 1
	},
/turf/open/floor/wood,
/area/ruins/lavaland/unpowered/russianbunker)
"ai" = (
/obj/structure/chair/stool/bar,
/mob/living/simple_animal/hostile/russian,
/turf/open/floor/wood,
/area/ruins/lavaland/unpowered/russianbunker)
"ak" = (
/turf/open/floor/wood{
	icon_state = "wood-broken4"
	},
/area/ruins/lavaland/unpowered/russianbunker)
"al" = (
/obj/machinery/jukebox,
/turf/open/floor/wood,
/area/ruins/lavaland/unpowered/russianbunker)
"am" = (
/obj/machinery/light{
	dir = 8;
	icon_state = "tube1"
	},
/turf/open/floor/wood,
/area/ruins/lavaland/unpowered/russianbunker)
"an" = (
/mob/living/simple_animal/hostile/viscerator{
	desc = "A small, twin-bladed machine capable of inflicting very deadly lacerations. This one appears to be painted in the colors of the russian flag.";
	faction = list("russian");
	name = "Russ-erator"
	},
/turf/open/floor/wood{
	icon_state = "wood-broken4"
	},
/area/ruins/lavaland/unpowered/russianbunker)
"ao" = (
/obj/structure/bed,
/turf/open/floor/wood,
/area/ruins/lavaland/unpowered/russianbunker)
"aq" = (
/obj/structure/table/wood/poker,
/obj/item/coin/diamond,
/obj/item/lighter,
/obj/item/toy/cards/cardhand,
/turf/open/floor/wood,
/area/ruins/lavaland/unpowered/russianbunker)
"as" = (
/obj/machinery/light{
	dir = 4
	},
/turf/open/floor/wood,
/area/ruins/lavaland/unpowered/russianbunker)
"at" = (
/obj/structure/bed,
/obj/item/bedsheet/brown,
/mob/living/simple_animal/hostile/russian,
/turf/open/floor/wood,
/area/ruins/lavaland/unpowered/russianbunker)
"au" = (
/obj/structure/chair/stool/bar,
/turf/open/floor/wood,
/area/ruins/lavaland/unpowered/russianbunker)
"ax" = (
/obj/structure/table/reinforced,
/obj/item/reagent_containers/food/snacks/burger/bearger,
/obj/item/reagent_containers/food/snacks/burger/bearger,
/obj/item/reagent_containers/food/snacks/burger/bearger,
/obj/item/reagent_containers/food/drinks/bottle/vodka/badminka{
	pixel_x = -9;
	pixel_y = -4
	},
/mob/living/simple_animal/hostile/viscerator{
	desc = "A small, twin-bladed machine capable of inflicting very deadly lacerations. This one appears to be painted in the colors of the russian flag.";
	faction = list("russian");
	name = "Russ-erator"
	},
/turf/open/floor/wood,
/area/ruins/lavaland/unpowered/russianbunker)
"ay" = (
/obj/effect/mine/gas/plasma,
/turf/open/floor/wood,
/area/ruins/lavaland/unpowered/russianbunker)
"aA" = (
/obj/structure/table/wood,
/obj/item/reagent_containers/food/snacks/meat/steak/bear,
/obj/item/reagent_containers/food/drinks/bottle/vodka,
/turf/open/floor/wood,
/area/ruins/lavaland/unpowered/russianbunker)
"aC" = (
/obj/machinery/vending/boozeomat,
/turf/open/floor/wood,
/area/ruins/lavaland/unpowered/russianbunker)
"aD" = (
/obj/structure/table/reinforced,
/obj/item/clothing/gloves/yogs/army,
/turf/open/floor/circuit/off,
/area/ruins/lavaland/unpowered/russianbunker)
"aE" = (
/obj/structure/table/reinforced,
/turf/open/floor/circuit/off,
/area/ruins/lavaland/unpowered/russianbunker)
"aF" = (
/obj/effect/spawner/structure/window/reinforced,
/turf/open/floor/plating,
/area/ruins/lavaland/unpowered/russianbunker)
"aG" = (
/obj/effect/decal/cleanable/blood/splatter,
/turf/open/floor/wood,
/area/ruins/lavaland/unpowered/russianbunker)
"aI" = (
/obj/machinery/light{
	dir = 8;
	icon_state = "tube1"
	},
/obj/structure/table/reinforced,
/obj/machinery/turretid{
	ailock = 1;
	control_area = null;
	desc = "A specially designed set of turret controls. Looks to be covered in protective casing to prevent AI interfacing.";
	icon_state = "control_kill";
	lethal = 1;
	name = "Shuttle turret control";
	pixel_x = 32;
	pixel_y = -28;
	req_access = list("syndicate")
	},
/obj/item/clothing/suit/armor/heavy/juggernaut,
/obj/item/clothing/head/helmet/juggernaut,
/turf/open/floor/circuit/off,
/area/ruins/lavaland/unpowered/russianbunker)
"aJ" = (
/mob/living/simple_animal/hostile/viscerator{
	desc = "A small, twin-bladed machine capable of inflicting very deadly lacerations. This one appears to be painted in the colors of the russian flag.";
	faction = list("russian");
	name = "Russ-erator"
	},
/mob/living/simple_animal/hostile/viscerator{
	desc = "A small, twin-bladed machine capable of inflicting very deadly lacerations. This one appears to be painted in the colors of the russian flag.";
	faction = list("russian");
	name = "Russ-erator"
	},
/mob/living/simple_animal/hostile/viscerator{
	desc = "A small, twin-bladed machine capable of inflicting very deadly lacerations. This one appears to be painted in the colors of the russian flag.";
	faction = list("russian");
	name = "Russ-erator"
	},
/mob/living/simple_animal/hostile/viscerator{
	desc = "A small, twin-bladed machine capable of inflicting very deadly lacerations. This one appears to be painted in the colors of the russian flag.";
	faction = list("russian");
	name = "Russ-erator"
	},
/mob/living/simple_animal/hostile/viscerator{
	desc = "A small, twin-bladed machine capable of inflicting very deadly lacerations. This one appears to be painted in the colors of the russian flag.";
	faction = list("russian");
	name = "Russ-erator"
	},
/mob/living/simple_animal/hostile/viscerator{
	desc = "A small, twin-bladed machine capable of inflicting very deadly lacerations. This one appears to be painted in the colors of the russian flag.";
	faction = list("russian");
	name = "Russ-erator"
	},
/mob/living/simple_animal/hostile/viscerator{
	desc = "A small, twin-bladed machine capable of inflicting very deadly lacerations. This one appears to be painted in the colors of the russian flag.";
	faction = list("russian");
	name = "Russ-erator"
	},
/turf/open/floor/circuit/off,
/area/ruins/lavaland/unpowered/russianbunker)
"aK" = (
/obj/machinery/door/airlock/hatch{
	locked = 1
	},
/turf/open/floor/pod,
/area/ruins/lavaland/unpowered/russianbunker)
"aL" = (
/obj/effect/decal/cleanable/blood/splatter,
/obj/item/ammo_casing/a357,
/turf/open/floor/wood{
	icon_state = "wood-broken4"
	},
/area/ruins/lavaland/unpowered/russianbunker)
"aM" = (
/obj/effect/decal/cleanable/blood/splatter,
/obj/effect/spawner/structure/window/reinforced,
/turf/open/floor/plating,
/area/ruins/lavaland/unpowered/russianbunker)
"aO" = (
/obj/machinery/chem_dispenser/drinks/beer,
/obj/structure/table,
/turf/open/floor/wood,
/area/ruins/lavaland/unpowered/russianbunker)
"aQ" = (
/obj/structure/table/reinforced,
/obj/item/clothing/neck/stripedbluescarf,
/obj/item/clothing/head/wizard/marisa/fake,
/turf/open/floor/circuit/off,
/area/ruins/lavaland/unpowered/russianbunker)
"aS" = (
/obj/machinery/light{
	dir = 4
	},
/obj/machinery/chem_dispenser/drinks/fullupgrade,
/obj/structure/table,
/turf/open/floor/wood,
/area/ruins/lavaland/unpowered/russianbunker)
"aT" = (
/obj/machinery/porta_turret/syndicate/energy/raven{
	armor = list("melee" = 90, "bullet" = 70, "laser" = 70, "energy" = 50, "bomb" = 100, "bio" = 0, "rad" = 0, "fire" = 90, "acid" = 90);
	desc = "A Raven-Class laser turret repurposed by the Russians for the defense of their numerous Bunkers. This turret appears to have anti-explosive plating.";
	faction = list("russian");
	name = "Russian Defense Turret MK-II"
	},
/turf/open/floor/circuit/off,
/area/ruins/lavaland/unpowered/russianbunker)
"aU" = (
/obj/machinery/light,
/obj/structure/table/reinforced,
/obj/item/storage/fancy/donut_box,
/turf/open/floor/wood,
/area/ruins/lavaland/unpowered/russianbunker)
"aX" = (
/obj/structure/table,
/obj/item/lighter,
/turf/open/floor/wood,
/area/ruins/lavaland/unpowered/russianbunker)
"aY" = (
/turf/open/floor/pod,
/area/ruins/lavaland/unpowered/russianbunker)
"aZ" = (
/obj/machinery/computer/arcade,
/turf/open/floor/wood,
/area/ruins/lavaland/unpowered/russianbunker)
"ba" = (
/obj/item/book/manual/wiki/barman_recipes,
/obj/structure/table,
/obj/item/vending_refill/wardrobe/bar_wardrobe,
/turf/open/floor/wood,
/area/ruins/lavaland/unpowered/russianbunker)
"bb" = (
/obj/item/cigbutt/cigarbutt,
/obj/effect/decal/cleanable/blood/drip,
/turf/open/floor/pod,
/area/ruins/lavaland/unpowered/russianbunker)
"bc" = (
/obj/structure/table,
/obj/item/kitchen/knife/butcher,
/obj/item/kitchen/knife/combat/survival,
/turf/open/floor/wood,
/area/ruins/lavaland/unpowered/russianbunker)
"be" = (
/obj/effect/decal/cleanable/blood/splatter,
/mob/living/simple_animal/hostile/bear/snow,
/turf/open/floor/grass/snow/safe,
/area/ruins/lavaland/unpowered/russianbunker)
"bf" = (
/obj/machinery/door/airlock/hatch{
	welded = 1
	},
/turf/open/floor/pod,
/area/ruins/lavaland/unpowered/russianbunker)
"bm" = (
/obj/structure/table,
/obj/machinery/microwave,
/turf/open/floor/wood,
/area/ruins/lavaland/unpowered/russianbunker)
"bn" = (
/obj/effect/decal/cleanable/blood/old,
/turf/open/floor/grass/snow/safe,
/area/ruins/lavaland/unpowered/russianbunker)
"bo" = (
/obj/machinery/door/airlock/hatch{
	locked = 1
	},
/obj/structure/fans/tiny,
/turf/open/floor/pod,
/area/ruins/lavaland/unpowered/russianbunker)
"bp" = (
/obj/structure/table,
/obj/item/mop,
/obj/item/reagent_containers/glass/bucket,
/turf/open/floor/wood,
/area/ruins/lavaland/unpowered/russianbunker)
"bq" = (
/obj/structure/table,
/mob/living/simple_animal/hostile/viscerator{
	desc = "A small, twin-bladed machine capable of inflicting very deadly lacerations. This one appears to be painted in the colors of the russian flag.";
	faction = list("russian");
	name = "Russ-erator"
	},
/turf/open/floor/wood,
/area/ruins/lavaland/unpowered/russianbunker)
"br" = (
/obj/machinery/keycard_auth{
	pixel_y = -7
	},
/turf/closed/wall/r_wall,
/area/ruins/lavaland/unpowered/russianbunker)
"bs" = (
/obj/machinery/space_heater,
/turf/open/floor/pod,
/area/ruins/lavaland/unpowered/russianbunker)
"bt" = (
/obj/item/cigbutt/cigarbutt,
/turf/open/floor/pod,
/area/ruins/lavaland/unpowered/russianbunker)
"bu" = (
/obj/machinery/suit_storage_unit/standard_unit,
/turf/open/floor/pod,
/area/ruins/lavaland/unpowered/russianbunker)
"bv" = (
/obj/machinery/light{
	dir = 8
	},
/turf/open/floor/circuit/off,
/area/ruins/lavaland/unpowered/russianbunker)
"bw" = (
/obj/machinery/light{
	dir = 4
	},
/turf/open/floor/circuit/off,
/area/ruins/lavaland/unpowered/russianbunker)
"cA" = (
/obj/effect/mob_spawn/human/corpse/damaged,
/turf/open/lava/smooth/lava_land_surface,
/area/external/mining/lavaland/explored)
"cG" = (
/obj/effect/decal/cleanable/blood/drip,
/obj/item/jawsoflife,
/mob/living/simple_animal/hostile/bear/snow,
/turf/open/floor/grass/snow/safe,
/area/ruins/lavaland/unpowered/russianbunker)
"fW" = (
/obj/structure/table/wood/poker,
/obj/item/coin/adamantine,
/obj/item/toy/cards/cardhand,
/turf/open/floor/wood,
/area/ruins/lavaland/unpowered/russianbunker)
"gj" = (
/obj/item/weldingtool/experimental,
/mob/living/simple_animal/hostile/bear,
/turf/open/floor/grass/snow/safe,
/area/ruins/lavaland/unpowered/russianbunker)
"gO" = (
/obj/machinery/chem_master/condimaster,
/turf/open/floor/wood,
/area/ruins/lavaland/unpowered/russianbunker)
"gY" = (
/obj/item/restraints/handcuffs,
/mob/living/simple_animal/hostile/viscerator{
	desc = "A small, twin-bladed machine capable of inflicting very deadly lacerations. This one appears to be painted in the colors of the russian flag.";
	faction = list("russian");
	name = "Russ-erator"
	},
/turf/open/floor/wood{
	icon_state = "wood-broken4"
	},
/area/ruins/lavaland/unpowered/russianbunker)
"hU" = (
/obj/item/cigbutt/cigarbutt,
/turf/open/floor/wood,
/area/ruins/lavaland/unpowered/russianbunker)
"io" = (
/obj/item/cigbutt/cigarbutt,
/turf/open/floor/wood{
	icon_state = "wood-broken4"
	},
/area/ruins/lavaland/unpowered/russianbunker)
"ir" = (
/obj/effect/mob_spawn/human/corpse/russian/ranged,
/obj/item/reagent_containers/food/snacks/burger/bearger,
/obj/effect/decal/cleanable/blood/drip,
/turf/open/floor/wood,
/area/ruins/lavaland/unpowered/russianbunker)
"iu" = (
/obj/structure/chair/comfy,
/mob/living/simple_animal/hostile/russian/ranged/officer,
/turf/open/floor/wood,
/area/ruins/lavaland/unpowered/russianbunker)
"js" = (
/obj/effect/mine/gas/plasma,
/turf/open/floor/pod,
/area/ruins/lavaland/unpowered/russianbunker)
"kN" = (
/obj/structure/sign/poster/contraband/d_day_promo,
/turf/closed/wall/r_wall,
/area/ruins/lavaland/unpowered/russianbunker)
"mO" = (
/obj/structure/table/wood,
/obj/item/reagent_containers/food/snacks/meat/steak/bear,
/obj/item/reagent_containers/food/drinks/bottle/vodka/badminka{
	pixel_x = -9;
	pixel_y = -4
	},
/turf/open/floor/wood,
/area/ruins/lavaland/unpowered/russianbunker)
"mQ" = (
/turf/template_noop,
/area/template_noop)
"nj" = (
/obj/effect/mine/stun,
/obj/effect/mob_spawn/human/corpse/nanotrasensoldier,
/turf/open/floor/pod,
/area/ruins/lavaland/unpowered/russianbunker)
"nU" = (
/obj/effect/mob_spawn/human/corpse/damaged,
/obj/effect/decal/cleanable/blood/splatter,
/obj/item/handdrill,
/turf/open/floor/grass/snow/safe,
/area/ruins/lavaland/unpowered/russianbunker)
"pB" = (
/obj/structure/sign/poster/contraband/kss13,
/turf/closed/indestructible/opshuttle,
/area/ruins/lavaland/unpowered/russianbunker)
"pP" = (
/obj/machinery/light{
	dir = 1
	},
/mob/living/simple_animal/hostile/russian/ranged/trooper,
/turf/open/floor/pod,
/area/ruins/lavaland/unpowered/russianbunker)
"qg" = (
/mob/living/simple_animal/hostile/russian/ranged/mosin,
/turf/open/floor/pod{
	initial_gas_mix = "o2=14;n2=23;TEMP=300"
	},
/area/external/mining/lavaland/explored)
"qF" = (
/obj/effect/mob_spawn/human/corpse/nanotrasensoldier,
/obj/effect/decal/cleanable/blood/drip,
/turf/open/floor/pod{
	initial_gas_mix = "o2=14;n2=23;TEMP=300"
	},
/area/external/mining/lavaland/explored)
"rK" = (
/obj/machinery/light,
/turf/open/floor/pod,
/area/ruins/lavaland/unpowered/russianbunker)
"tJ" = (
/mob/living/simple_animal/hostile/russian/ranged/trooper,
/turf/open/floor/wood,
/area/ruins/lavaland/unpowered/russianbunker)
"um" = (
/obj/effect/decal/cleanable/blood/old,
/turf/open/floor/pod{
	initial_gas_mix = "o2=14;n2=23;TEMP=300"
	},
/area/external/mining/lavaland/explored)
"vc" = (
/obj/structure/reagent_dispensers/fueltank,
/turf/open/floor/wood,
/area/ruins/lavaland/unpowered/russianbunker)
"ww" = (
/obj/effect/decal/cleanable/blood/splatter,
/turf/closed/wall/r_wall,
/area/ruins/lavaland/unpowered/russianbunker)
"xs" = (
/obj/effect/decal/cleanable/blood/splatter,
/mob/living/simple_animal/hostile/russian/ranged/trooper,
/turf/open/floor/pod,
/area/ruins/lavaland/unpowered/russianbunker)
"xP" = (
/mob/living/simple_animal/hostile/bear,
/turf/open/floor/grass/snow/safe,
/area/ruins/lavaland/unpowered/russianbunker)
"xW" = (
/obj/effect/decal/cleanable/blood/splatter,
/turf/open/floor/pod{
	initial_gas_mix = "o2=14;n2=23;TEMP=300"
	},
/area/external/mining/lavaland/explored)
"xZ" = (
/obj/structure/reagent_dispensers/watertank,
/turf/open/floor/wood,
/area/ruins/lavaland/unpowered/russianbunker)
"yw" = (
/obj/structure/sign/poster/contraband/syndicate_recruitment,
/turf/closed/wall/r_wall,
/area/ruins/lavaland/unpowered/russianbunker)
"zv" = (
/mob/living/simple_animal/hostile/russian/ranged/mosin,
/turf/open/floor/wood,
/area/ruins/lavaland/unpowered/russianbunker)
"zB" = (
/obj/item/restraints/handcuffs,
/obj/effect/decal/cleanable/blood/old,
/turf/open/floor/pod,
/area/ruins/lavaland/unpowered/russianbunker)
"Am" = (
/obj/structure/table/wood,
/obj/item/reagent_containers/food/snacks/meat/steak/bear,
/obj/item/lighter,
/turf/open/floor/wood,
/area/ruins/lavaland/unpowered/russianbunker)
"Bu" = (
/obj/effect/decal/cleanable/blood/drip,
/obj/effect/spawner/structure/window/reinforced,
/turf/open/floor/plating,
/area/ruins/lavaland/unpowered/russianbunker)
"BL" = (
/obj/effect/decal/cleanable/blood/drip,
/mob/living/simple_animal/hostile/russian/ranged/mosin,
/turf/open/floor/pod{
	initial_gas_mix = "o2=14;n2=23;TEMP=300"
	},
/area/external/mining/lavaland/explored)
"Cf" = (
/obj/effect/mob_spawn/human/corpse/nanotrasensoldier,
/turf/open/floor/grass/snow/safe,
/area/ruins/lavaland/unpowered/russianbunker)
"Cu" = (
/obj/effect/decal/cleanable/blood/drip,
/turf/open/floor/pod,
/area/ruins/lavaland/unpowered/russianbunker)
"Dm" = (
/obj/item/ammo_casing/a357,
/mob/living/simple_animal/hostile/viscerator{
	desc = "A small, twin-bladed machine capable of inflicting very deadly lacerations. This one appears to be painted in the colors of the russian flag.";
	faction = list("russian");
	name = "Russ-erator"
	},
/turf/open/floor/wood,
/area/ruins/lavaland/unpowered/russianbunker)
"DN" = (
/obj/effect/decal/cleanable/blood/drip,
/turf/open/floor/pod{
	initial_gas_mix = "o2=14;n2=23;TEMP=300"
	},
/area/external/mining/lavaland/explored)
"DQ" = (
/obj/effect/decal/cleanable/blood/drip,
/obj/effect/decal/cleanable/blood/splatter,
/turf/open/floor/pod,
/area/ruins/lavaland/unpowered/russianbunker)
"DW" = (
/obj/machinery/door/airlock/hatch{
	locked = 1
	},
/turf/open/floor/wood,
/area/ruins/lavaland/unpowered/russianbunker)
"Fk" = (
/obj/structure/table/wood/poker,
/obj/item/coin/adamantine,
/obj/item/coin/diamond,
/obj/item/reagent_containers/food/drinks/bottle/vodka,
/obj/item/toy/cards/cardhand,
/turf/open/floor/wood,
/area/ruins/lavaland/unpowered/russianbunker)
"FI" = (
/obj/structure/table/wood/poker,
/obj/item/coin/mythril,
/obj/item/coin/diamond,
/obj/item/dice/d6,
/obj/item/toy/cards/cardhand,
/turf/open/floor/wood,
/area/ruins/lavaland/unpowered/russianbunker)
"FM" = (
/obj/structure/table/wood/poker,
/obj/item/coin/antagtoken,
/obj/item/toy/cards/deck/syndicate,
/turf/open/floor/wood,
/area/ruins/lavaland/unpowered/russianbunker)
"Gq" = (
/obj/machinery/door/airlock/hatch,
/turf/open/floor/wood,
/area/ruins/lavaland/unpowered/russianbunker)
"GM" = (
/obj/structure/sign/poster/contraband/communist_state,
/turf/closed/wall/r_wall,
/area/ruins/lavaland/unpowered/russianbunker)
"Hk" = (
/obj/structure/chair/stool/bar,
/mob/living/simple_animal/hostile/russian/ranged/mosin,
/turf/open/floor/wood,
/area/ruins/lavaland/unpowered/russianbunker)
"IF" = (
/obj/item/reagent_containers/food/snacks/meat/slab/bear,
/obj/effect/decal/cleanable/blood/drip,
/turf/open/floor/grass/snow/safe,
/area/ruins/lavaland/unpowered/russianbunker)
"IL" = (
/obj/structure/bed,
/obj/item/bedsheet/red,
/turf/open/floor/wood,
/area/ruins/lavaland/unpowered/russianbunker)
"IX" = (
/obj/machinery/vending/sovietsoda,
/turf/open/floor/wood,
/area/ruins/lavaland/unpowered/russianbunker)
"JQ" = (
/obj/structure/table/wood,
/obj/item/reagent_containers/food/snacks/burger/bearger,
/turf/open/floor/wood,
/area/ruins/lavaland/unpowered/russianbunker)
"KH" = (
/obj/effect/decal/cleanable/blood/splatter,
/mob/living/simple_animal/hostile/viscerator{
	desc = "A small, twin-bladed machine capable of inflicting very deadly lacerations. This one appears to be painted in the colors of the russian flag.";
	faction = list("russian");
	name = "Russ-erator"
	},
/turf/open/floor/wood,
/area/ruins/lavaland/unpowered/russianbunker)
"KV" = (
/obj/structure/table/reinforced,
/obj/item/reagent_containers/food/snacks/bearsteak,
/obj/item/reagent_containers/food/snacks/bearsteak,
/mob/living/simple_animal/hostile/viscerator{
	desc = "A small, twin-bladed machine capable of inflicting very deadly lacerations. This one appears to be painted in the colors of the russian flag.";
	faction = list("russian");
	name = "Russ-erator"
	},
/turf/open/floor/wood,
/area/ruins/lavaland/unpowered/russianbunker)
"LK" = (
/obj/structure/table/wood,
/obj/item/reagent_containers/food/snacks/bearsteak,
/obj/item/reagent_containers/food/drinks/bottle/vodka,
/turf/open/floor/wood,
/area/ruins/lavaland/unpowered/russianbunker)
"Mo" = (
/obj/structure/table/wood,
/obj/item/reagent_containers/food/snacks/bearsteak,
/turf/open/floor/wood,
/area/ruins/lavaland/unpowered/russianbunker)
"MC" = (
/obj/effect/decal/cleanable/blood/old,
/turf/open/floor/pod,
/area/ruins/lavaland/unpowered/russianbunker)
"MU" = (
/turf/open/floor/plating,
/area/ruins/lavaland/unpowered/russianbunker)
"Ni" = (
/turf/closed/indestructible/opshuttle,
/area/ruins/lavaland/unpowered/russianbunker)
"OY" = (
/obj/machinery/light{
	dir = 8;
	icon_state = "tube1"
	},
/obj/structure/statue/sandstone/assistant,
/turf/open/floor/wood,
/area/ruins/lavaland/unpowered/russianbunker)
"Pu" = (
/obj/item/cigbutt/cigarbutt,
/obj/machinery/light{
	dir = 1
	},
/turf/open/floor/pod{
	initial_gas_mix = "o2=14;n2=23;TEMP=300"
	},
/area/external/mining/lavaland/explored)
"PR" = (
/obj/structure/sign/poster/contraband/power,
/turf/closed/wall/r_wall,
/area/ruins/lavaland/unpowered/russianbunker)
"QW" = (
/obj/machinery/door/airlock/hatch,
/turf/open/floor/pod,
/area/ruins/lavaland/unpowered/russianbunker)
"QZ" = (
/obj/machinery/door/airlock/hatch{
	welded = 1
	},
/turf/open/floor/holofloor/wood,
/area/ruins/lavaland/unpowered/russianbunker)
"Rh" = (
/turf/open/floor/pod{
	initial_gas_mix = "o2=14;n2=23;TEMP=300"
	},
/area/external/mining/lavaland/explored)
"Rv" = (
/obj/effect/mob_spawn/human/corpse/nanotrasensoldier,
/turf/open/floor/pod{
	initial_gas_mix = "o2=14;n2=23;TEMP=300"
	},
/area/external/mining/lavaland/explored)
"RY" = (
/obj/effect/decal/cleanable/blood/splatter,
/turf/open/floor/grass/snow/safe,
/area/ruins/lavaland/unpowered/russianbunker)
"Sw" = (
/obj/structure/sign/poster/contraband/eat,
/turf/closed/wall/r_wall,
/area/ruins/lavaland/unpowered/russianbunker)
"SI" = (
/obj/machinery/porta_turret/syndicate/energy/raven{
	armor = list("melee" = 90, "bullet" = 70, "laser" = 70, "energy" = 50, "bomb" = 100, "bio" = 0, "rad" = 0, "fire" = 90, "acid" = 90);
	desc = "A Raven-Class laser turret repurposed by the Russians for the defense of their numerous Bunkers. This turret appears to have anti-explosive plating.";
	faction = list("russian");
	name = "Russian Defense Turret MK-II"
	},
/obj/machinery/light{
	dir = 4
	},
/turf/open/floor/circuit/off,
/area/ruins/lavaland/unpowered/russianbunker)
"VP" = (
/obj/machinery/light{
	dir = 1
	},
/turf/open/floor/pod{
	initial_gas_mix = "o2=14;n2=23;TEMP=300"
	},
/area/external/mining/lavaland/explored)
"Wj" = (
/obj/structure/barricade/sandbags,
/turf/open/floor/pod{
	initial_gas_mix = "o2=14;n2=23;TEMP=300"
	},
/area/external/mining/lavaland/explored)
"XY" = (
/obj/effect/mob_spawn/human/corpse/nanotrasensoldier,
/obj/effect/decal/cleanable/blood/old,
/obj/machinery/light{
	dir = 8
	},
/turf/open/floor/grass/snow/safe,
/area/ruins/lavaland/unpowered/russianbunker)
"Yi" = (
/obj/effect/decal/cleanable/blood/drip,
/obj/structure/statue/snow/snowman,
/turf/open/floor/grass/snow/safe,
/area/ruins/lavaland/unpowered/russianbunker)
"YQ" = (
/turf/closed/wall/r_wall,
/area/ruins/lavaland/unpowered/russianbunker)
"ZD" = (
/obj/effect/decal/cleanable/blood/drip,
/mob/living/simple_animal/hostile/viscerator{
	desc = "A small, twin-bladed machine capable of inflicting very deadly lacerations. This one appears to be painted in the colors of the russian flag.";
	faction = list("russian");
	name = "Russ-erator"
	},
/turf/open/floor/wood,
/area/ruins/lavaland/unpowered/russianbunker)
"ZP" = (
/obj/structure/statue/sandstone/assistant,
/turf/open/floor/wood,
/area/ruins/lavaland/unpowered/russianbunker)
"ZU" = (
/obj/effect/decal/cleanable/blood/old,
/mob/living/simple_animal/hostile/bear,
/turf/open/floor/grass/snow/safe,
/area/ruins/lavaland/unpowered/russianbunker)

(1,1,1) = {"
mQ
mQ
mQ
mQ
mQ
mQ
mQ
mQ
mQ
mQ
mQ
mQ
mQ
mQ
mQ
mQ
mQ
mQ
mQ
mQ
mQ
mQ
mQ
mQ
mQ
mQ
mQ
mQ
mQ
mQ
mQ
mQ
mQ
mQ
mQ
"}
(2,1,1) = {"
mQ
mQ
mQ
mQ
mQ
mQ
ab
mQ
mQ
mQ
mQ
mQ
mQ
mQ
mQ
mQ
mQ
mQ
mQ
mQ
mQ
mQ
mQ
mQ
mQ
mQ
mQ
mQ
mQ
mQ
mQ
mQ
mQ
mQ
mQ
"}
(3,1,1) = {"
mQ
mQ
mQ
mQ
mQ
mQ
ab
ab
ab
mQ
mQ
mQ
ab
ab
ab
mQ
mQ
mQ
mQ
mQ
mQ
ab
ab
mQ
mQ
mQ
mQ
mQ
mQ
mQ
mQ
mQ
mQ
mQ
mQ
"}
(4,1,1) = {"
mQ
mQ
mQ
mQ
mQ
mQ
mQ
ab
ab
ab
ab
ab
ab
ab
ab
ab
ab
ab
ab
mQ
mQ
ab
mQ
mQ
mQ
mQ
mQ
mQ
mQ
mQ
mQ
mQ
mQ
mQ
mQ
"}
(5,1,1) = {"
mQ
mQ
mQ
mQ
mQ
mQ
mQ
mQ
ab
ab
ab
ab
ab
ac
ab
ab
ab
ab
ab
ab
ab
ab
mQ
mQ
mQ
ab
ab
ab
mQ
mQ
mQ
mQ
mQ
mQ
mQ
"}
(6,1,1) = {"
mQ
mQ
mQ
mQ
mQ
ab
mQ
ab
ab
ab
ab
ac
ab
ab
ab
ac
ab
ac
ab
ab
ab
ab
mQ
mQ
ab
ab
mQ
mQ
mQ
mQ
mQ
mQ
mQ
mQ
mQ
"}
(7,1,1) = {"
mQ
mQ
mQ
mQ
mQ
ab
ab
ab
ab
ac
ac
ac
ab
ab
ac
ac
ac
ab
ab
ab
ab
ab
ab
ab
ab
ab
ab
mQ
mQ
mQ
ab
mQ
mQ
mQ
mQ
"}
(8,1,1) = {"
mQ
ab
mQ
ab
ab
ab
ab
ab
ab
YQ
YQ
YQ
YQ
YQ
YQ
YQ
ac
ac
ab
ab
ac
ab
ab
ac
ab
ab
ab
mQ
mQ
mQ
mQ
ab
mQ
mQ
mQ
"}
(9,1,1) = {"
mQ
ab
ab
ab
ab
ab
ab
ac
ac
YQ
Ni
Ni
Ni
Ni
Ni
YQ
ac
ab
ab
ab
ab
ab
ab
ab
ab
ab
ab
ab
ab
mQ
ab
mQ
mQ
mQ
ab
"}
(10,1,1) = {"
mQ
mQ
ab
ab
ab
ab
ab
ac
ac
YQ
Ni
aD
aI
aE
Ni
YQ
YQ
ab
ab
ab
ab
ab
cA
ab
ab
mQ
ab
ab
ab
cA
mQ
mQ
mQ
ab
ab
"}
(11,1,1) = {"
mQ
ab
ab
ab
ab
ab
ac
ac
ac
YQ
Ni
aE
aJ
aQ
Ni
YQ
YQ
aF
YQ
aF
YQ
ad
ab
ab
ab
ab
ab
ab
mQ
mQ
mQ
mQ
mQ
ab
mQ
"}
(12,1,1) = {"
mQ
ab
ab
ab
ad
YQ
YQ
YQ
YQ
YQ
Ni
pB
aK
Ni
Ni
YQ
gj
RY
XY
cG
ZU
YQ
ab
ab
ab
ab
cA
mQ
ab
mQ
mQ
mQ
ab
mQ
ab
"}
(13,1,1) = {"
ab
ab
ab
ac
YQ
ae
am
ao
at
YQ
ax
ak
Dm
aF
aT
YQ
Yi
xP
xP
IF
Cf
YQ
YQ
ab
ab
ab
ab
ab
mQ
mQ
mQ
mQ
mQ
cA
mQ
"}
(14,1,1) = {"
ab
ab
ac
ac
YQ
af
ag
ak
ag
DW
ay
ZD
aL
aF
aU
YQ
nU
IF
be
xP
bn
YQ
YQ
YQ
YQ
YQ
YQ
YQ
Wj
Wj
Wj
Wj
mQ
mQ
mQ
"}
(15,1,1) = {"
ab
ab
ab
ab
YQ
ae
ag
IL
vc
PR
KV
aG
an
Bu
aT
YQ
MU
MU
bf
MU
MU
YQ
YQ
YQ
YQ
YQ
YQ
YQ
DN
Rh
BL
Wj
mQ
mQ
mQ
"}
(16,1,1) = {"
mQ
ab
ab
ab
YQ
YQ
Gq
YQ
YQ
YQ
YQ
aF
aM
ww
YQ
YQ
zB
js
aY
aY
aY
YQ
bs
Cu
YQ
bv
aT
YQ
VP
xW
Rh
Wj
mQ
ab
mQ
"}
(17,1,1) = {"
mQ
ab
ac
ab
YQ
ag
ag
ag
ag
ag
OY
ag
hU
ZP
hU
GM
aY
YQ
aY
GM
MC
Sw
pP
DQ
YQ
aF
aF
GM
Rh
Rv
DN
Wj
mQ
mQ
mQ
"}
(18,1,1) = {"
mQ
ab
ac
ab
YQ
ah
ai
ak
ag
ag
ag
ag
ak
ag
ag
QW
aY
aY
aY
js
aY
aK
bt
Cu
aK
aY
nj
bo
xW
um
qg
Wj
mQ
mQ
ab
"}
(19,1,1) = {"
ab
ab
ac
ac
YQ
ag
Fk
FI
Hk
ak
ai
au
ai
au
au
GM
Cu
yw
js
GM
aY
br
xs
rK
YQ
aF
aF
GM
Rh
DN
Rh
Wj
mQ
ab
mQ
"}
(20,1,1) = {"
ab
ab
ab
ab
YQ
iu
FM
fW
au
ag
LK
JQ
Am
Mo
mO
YQ
aY
bb
Cu
aY
aY
YQ
bu
bu
YQ
bw
aT
YQ
Pu
Rh
xW
Wj
mQ
ab
mQ
"}
(21,1,1) = {"
ab
ab
ab
ab
YQ
ag
FI
aq
ag
ag
aA
ag
tJ
ag
zv
YQ
YQ
YQ
QZ
YQ
YQ
YQ
YQ
YQ
YQ
kN
YQ
YQ
xW
BL
qF
Wj
mQ
cA
mQ
"}
(22,1,1) = {"
ab
ab
ab
ab
YQ
ak
ag
ai
ag
io
ag
ag
ak
ag
ag
YQ
IX
gY
ir
KH
xZ
YQ
YQ
YQ
YQ
YQ
YQ
YQ
Wj
Wj
Wj
Wj
mQ
mQ
mQ
"}
(23,1,1) = {"
mQ
ab
ab
ab
YQ
al
IX
as
ag
ag
aC
gO
aO
aS
aX
YQ
aZ
aG
an
ak
bp
YQ
YQ
ab
ab
ab
ab
ab
mQ
mQ
mQ
mQ
mQ
mQ
mQ
"}
(24,1,1) = {"
mQ
ab
ab
ab
ad
YQ
YQ
YQ
YQ
YQ
YQ
YQ
YQ
YQ
YQ
YQ
ba
bc
SI
bm
bq
YQ
ac
ab
ab
ab
ab
ab
ab
cA
mQ
mQ
mQ
mQ
ab
"}
(25,1,1) = {"
mQ
ab
ab
ab
ab
ab
ac
ab
ab
ab
ab
ab
ac
ac
ac
YQ
YQ
YQ
YQ
YQ
YQ
ad
ab
ac
ab
cA
ab
ab
ab
ab
ab
mQ
ab
ab
mQ
"}
(26,1,1) = {"
mQ
mQ
ab
ab
ab
ab
ab
ab
ac
ac
ab
ab
ab
ac
ac
ac
ac
ab
ab
ab
ab
ab
ab
ac
ab
ab
mQ
ab
ab
ab
mQ
ab
ab
mQ
mQ
"}
(27,1,1) = {"
mQ
mQ
mQ
mQ
mQ
mQ
ab
ac
ac
ac
ac
ab
ab
ac
ac
ac
ab
ab
ac
ac
ab
ab
ab
ab
ab
ab
ab
mQ
ab
ab
ab
ab
mQ
mQ
mQ
"}
(28,1,1) = {"
mQ
mQ
mQ
mQ
mQ
mQ
ab
ac
ac
ab
ab
ab
ab
ab
ac
ac
ab
ab
ab
ab
ab
ab
ab
ab
mQ
ab
ab
ab
ab
ab
ab
mQ
mQ
mQ
mQ
"}
(29,1,1) = {"
mQ
mQ
mQ
mQ
mQ
ab
ab
ab
ab
ab
ab
ab
aa
ab
ab
ab
ab
ab
ab
ab
mQ
ab
ab
ab
ab
ab
ab
mQ
ab
ab
cA
ab
mQ
mQ
mQ
"}
(30,1,1) = {"
mQ
mQ
mQ
mQ
ab
ab
ab
ab
ab
aa
ab
ab
ab
ab
ac
ab
ab
ab
ab
ab
mQ
mQ
mQ
ab
ab
ab
ab
ab
mQ
mQ
ab
ab
mQ
mQ
mQ
"}
(31,1,1) = {"
mQ
mQ
mQ
mQ
ab
ab
mQ
mQ
ab
ab
ab
aa
ab
ab
ab
ab
aa
ab
ab
ab
mQ
mQ
mQ
mQ
ab
ab
mQ
mQ
mQ
mQ
mQ
mQ
mQ
mQ
mQ
"}
(32,1,1) = {"
mQ
mQ
mQ
mQ
mQ
mQ
mQ
mQ
mQ
mQ
ab
ab
mQ
ab
ab
ab
ab
mQ
mQ
ab
ab
mQ
mQ
mQ
ab
ab
ab
ab
mQ
mQ
mQ
mQ
mQ
mQ
mQ
"}
(33,1,1) = {"
mQ
mQ
mQ
mQ
mQ
mQ
mQ
mQ
mQ
mQ
mQ
mQ
mQ
mQ
mQ
mQ
mQ
mQ
mQ
mQ
ab
ab
mQ
mQ
mQ
ab
ab
ab
ab
mQ
mQ
mQ
mQ
mQ
mQ
"}
(34,1,1) = {"
mQ
mQ
mQ
mQ
mQ
mQ
mQ
mQ
mQ
mQ
mQ
mQ
mQ
mQ
mQ
mQ
mQ
mQ
mQ
mQ
ab
ab
mQ
mQ
mQ
ab
ab
mQ
ab
ab
mQ
mQ
mQ
mQ
mQ
"}
(35,1,1) = {"
mQ
mQ
mQ
mQ
mQ
mQ
mQ
mQ
mQ
mQ
mQ
mQ
mQ
mQ
mQ
mQ
mQ
mQ
mQ
mQ
mQ
ab
mQ
mQ
mQ
mQ
mQ
mQ
mQ
mQ
mQ
mQ
mQ
mQ
mQ
"}
