//MAP CONVERTED BY dmm2tgm.py THIS HEADER COMMENT PREVENTS RECONVERSION, DO NOT REMOVE
"a" = (
/turf/template_noop,
/area/template_noop)
"b" = (
/turf/closed/wall/mineral/titanium/nodiagonal,
/area/ruins/lavaland/powered/generic)
"c" = (
/obj/machinery/door/airlock/external,
/obj/structure/fans/tiny/invisible,
/turf/open/floor/mineral/plastitanium/red/brig,
/area/ruins/lavaland/powered/generic)
"d" = (
/turf/closed/wall/mineral/titanium/interior,
/area/ruins/lavaland/powered/generic)
"e" = (
/turf/open/floor/mineral/plastitanium/red/brig,
/area/ruins/lavaland/powered/generic)
"f" = (
/obj/effect/decal/cleanable/blood,
/obj/effect/mob_spawn/human/corpse/syndicatesoldier,
/turf/open/floor/mineral/plastitanium/red/brig,
/area/ruins/lavaland/powered/generic)
"g" = (
/obj/item/ammo_casing/a762,
/turf/open/floor/mineral/plastitanium/red/brig,
/area/ruins/lavaland/powered/generic)
"h" = (
/obj/effect/decal/cleanable/xenoblood,
/obj/machinery/light{
	dir = 1
	},
/obj/item/tank/internals/oxygen,
/turf/open/floor/mineral/plastitanium/red/brig,
/area/ruins/lavaland/powered/generic)
"i" = (
/obj/machinery/door/airlock/hatch,
/obj/structure/fans/tiny/invisible,
/turf/open/floor/mineral/plastitanium/red/brig,
/area/ruins/lavaland/powered/generic)
"j" = (
/turf/closed/wall/mineral/titanium,
/area/ruins/lavaland/powered/generic)
"k" = (
/obj/structure/chair,
/mob/living/simple_animal/hostile/alien/sentinel,
/turf/open/floor/mineral/plastitanium/red/brig,
/area/ruins/lavaland/powered/generic)
"l" = (
/obj/structure/chair,
/turf/open/floor/mineral/plastitanium/red/brig,
/area/ruins/lavaland/powered/generic)
"m" = (
/obj/effect/decal/cleanable/blood,
/obj/item/chair,
/obj/effect/mob_spawn/human/corpse/syndicatesoldier,
/turf/open/floor/mineral/plastitanium/red/brig,
/area/ruins/lavaland/powered/generic)
"n" = (
/obj/item/trash/syndi_cakes,
/turf/open/floor/mineral/plastitanium/red/brig,
/area/ruins/lavaland/powered/generic)
"o" = (
/obj/effect/decal/cleanable/blood,
/turf/open/floor/mineral/plastitanium/red/brig,
/area/ruins/lavaland/powered/generic)
"p" = (
/obj/effect/decal/cleanable/xenoblood,
/turf/open/floor/mineral/plastitanium/red/brig,
/area/ruins/lavaland/powered/generic)
"q" = (
/obj/machinery/light{
	dir = 4;
	icon_state = "tube1"
	},
/turf/open/floor/mineral/plastitanium/red/brig,
/area/ruins/lavaland/powered/generic)
"r" = (
/obj/machinery/light{
	dir = 8;
	icon_state = "tube1"
	},
/turf/open/floor/mineral/plastitanium/red/brig,
/area/ruins/lavaland/powered/generic)
"s" = (
/obj/item/chair,
/turf/open/floor/mineral/plastitanium/red/brig,
/area/ruins/lavaland/powered/generic)
"t" = (
/obj/structure/closet/crate,
/obj/item/clothing/glasses/meson/night,
/obj/item/toy/nuke,
/obj/item/toy/figure/syndie,
/turf/open/floor/mineral/plastitanium/red/brig,
/area/ruins/lavaland/powered/generic)
"v" = (
/obj/structure/shuttle/engine/propulsion,
/turf/template_noop,
/area/template_noop)
"w" = (
/obj/structure/shuttle/engine/platform,
/turf/closed/wall/mineral/titanium,
/area/ruins/lavaland/powered/generic)
"E" = (
/obj/structure/table,
/turf/open/floor/mineral/plastitanium/red/brig,
/area/ruins/lavaland/powered/generic)

(1,1,1) = {"
a
a
a
a
a
a
a
a
a
a
"}
(2,1,1) = {"
b
d
d
d
d
d
j
b
a
a
"}
(3,1,1) = {"
j
e
j
k
n
r
f
w
v
a
"}
(4,1,1) = {"
d
f
j
l
o
e
s
j
a
a
"}
(5,1,1) = {"
c
g
i
e
p
e
t
j
a
a
"}
(6,1,1) = {"
d
h
j
l
e
o
p
j
a
a
"}
(7,1,1) = {"
j
e
j
m
q
e
E
w
v
a
"}
(8,1,1) = {"
b
d
d
j
j
j
j
b
a
a
"}
(9,1,1) = {"
a
a
a
a
a
a
a
a
a
a
"}
(10,1,1) = {"
a
a
a
a
a
a
a
a
a
a
"}
