//MAP CONVERTED BY dmm2tgm.py THIS HEADER COMMENT PREVENTS RECONVERSION, DO NOT REMOVE
"a" = (
/turf/template_noop,
/area/template_noop)
"b" = (
/turf/closed/mineral/volcanic/lava_land_surface,
/area/external/mining/lavaland/explored)
"c" = (
/turf/open/floor/plating/asteroid/basalt/lava_land_surface,
/area/external/mining/lavaland/explored)
"u" = (
/obj/effect/decal/remains/human,
/turf/open/floor/plating/asteroid/basalt/lava_land_surface,
/area/external/mining/lavaland/explored)
"w" = (
/obj/item/clothing/under/rank/cargo/miner/lavaland,
/turf/open/floor/plating/asteroid/basalt/lava_land_surface,
/area/external/mining/lavaland/explored)
"K" = (
/obj/item/clothing/shoes/workboots/mining,
/turf/open/floor/plating/asteroid/basalt/lava_land_surface,
/area/external/mining/lavaland/explored)
"O" = (
/obj/mecha/working/ripley/firefighter{
	ruin_mecha = 1
	},
/turf/open/floor/plating/asteroid/basalt/lava_land_surface,
/area/external/mining/lavaland/explored)
"V" = (
/obj/item/mecha_parts/mecha_equipment/drill,
/turf/open/floor/plating/asteroid/basalt/lava_land_surface,
/area/external/mining/lavaland/explored)

(1,1,1) = {"
a
b
b
b
a
"}
(2,1,1) = {"
b
c
b
w
b
"}
(3,1,1) = {"
b
c
O
u
b
"}
(4,1,1) = {"
b
K
V
b
b
"}
(5,1,1) = {"
b
b
b
b
a
"}
