//MAP CONVERTED BY dmm2tgm.py THIS HEADER COMMENT PREVENTS RECONVERSION, DO NOT REMOVE
"a" = (
/turf/closed/mineral/volcanic/lava_land_surface,
/area/external/mining/lavaland/explored)
"c" = (
/turf/closed/wall/mineral/iron,
/area/ruins/lavaland/powered/generic)
"e" = (
/obj/item/clothing/suit/space/orange,
/turf/open/floor/plating/asteroid/basalt,
/area/ruins/lavaland/powered/generic)
"f" = (
/turf/open/floor/plating/asteroid/basalt,
/area/ruins/lavaland/powered/generic)
"g" = (
/turf/open/floor/plating/asteroid{
	name = "dirt"
	},
/area/ruins/lavaland/powered/generic)
"h" = (
/obj/item/shovel,
/turf/open/floor/plating/asteroid{
	name = "dirt"
	},
/area/ruins/lavaland/powered/generic)
"i" = (
/obj/item/reagent_containers/glass/bucket,
/turf/open/floor/plating/asteroid{
	name = "dirt"
	},
/area/ruins/lavaland/powered/generic)
"j" = (
/obj/structure/sink/puddle,
/turf/open/floor/plating/asteroid{
	name = "dirt"
	},
/area/ruins/lavaland/powered/generic)
"k" = (
/obj/structure/glowshroom/single,
/turf/open/floor/plating/asteroid{
	name = "dirt"
	},
/area/ruins/lavaland/powered/generic)
"l" = (
/obj/item/storage/toolbox/emergency,
/turf/open/floor/plating/asteroid{
	name = "dirt"
	},
/area/ruins/lavaland/powered/generic)
"n" = (
/obj/machinery/hydroponics/soil,
/turf/open/floor/plating,
/area/ruins/lavaland/powered/generic)
"o" = (
/turf/open/floor/plating,
/area/ruins/lavaland/powered/generic)
"p" = (
/obj/structure/rack,
/obj/item/storage/bag/plants/portaseeder,
/obj/item/storage/bag/ore,
/obj/item/storage/firstaid/regular,
/turf/open/floor/plating/asteroid/basalt,
/area/ruins/lavaland/powered/generic)
"q" = (
/obj/structure/glowshroom/single,
/turf/open/floor/plating,
/area/ruins/lavaland/powered/generic)
"r" = (
/obj/structure/rack,
/obj/item/pickaxe/emergency,
/obj/item/tank/internals/oxygen,
/turf/open/floor/plating/asteroid/basalt,
/area/ruins/lavaland/powered/generic)
"s" = (
/turf/open/floor/plating/asteroid/basalt/lava_land_surface,
/area/external/mining/lavaland/explored)
"t" = (
/turf/closed/wall/mineral/titanium/survival/pod,
/area/ruins/lavaland/powered/generic)
"u" = (
/obj/structure/bed/pod,
/obj/item/bedsheet/black,
/turf/open/floor/plating,
/area/ruins/lavaland/powered/generic)
"v" = (
/obj/structure/fans,
/turf/open/floor/pod/dark,
/area/ruins/lavaland/powered/generic)
"w" = (
/obj/machinery/smartfridge/survival_pod,
/turf/open/floor/pod/dark,
/area/ruins/lavaland/powered/generic)
"x" = (
/obj/effect/mob_spawn/human/hermit,
/turf/open/floor/pod/dark,
/area/ruins/lavaland/powered/generic)
"y" = (
/turf/open/floor/pod/dark,
/area/ruins/lavaland/powered/generic)
"z" = (
/obj/machinery/light/small{
	dir = 4
	},
/obj/structure/tubes,
/turf/open/floor/plating,
/area/ruins/lavaland/powered/generic)
"A" = (
/obj/structure/table,
/obj/item/kitchen/knife/combat/survival,
/turf/open/floor/plating,
/area/ruins/lavaland/powered/generic)
"B" = (
/obj/structure/table/survival_pod,
/turf/open/floor/pod/dark,
/area/ruins/lavaland/powered/generic)
"C" = (
/obj/structure/tubes,
/obj/item/crowbar,
/obj/effect/decal/cleanable/blood/drip,
/turf/open/floor/pod/dark,
/area/ruins/lavaland/powered/generic)
"D" = (
/obj/effect/decal/cleanable/blood/footprints{
	dir = 1
	},
/obj/machinery/door/airlock/survival_pod/glass,
/obj/structure/fans/tiny,
/turf/open/floor/pod/dark,
/area/ruins/lavaland/powered/generic)
"E" = (
/obj/structure/shuttle/engine/propulsion/burst{
	dir = 8
	},
/turf/closed/wall/mineral/titanium/interior,
/area/ruins/lavaland/powered/generic)
"F" = (
/turf/closed/wall/mineral/titanium,
/area/ruins/lavaland/powered/generic)
"G" = (
/turf/closed/wall/mineral/titanium/interior,
/area/ruins/lavaland/powered/generic)
"H" = (
/obj/machinery/door/airlock/titanium{
	name = "Escape Pod Airlock"
	},
/turf/open/floor/mineral/titanium/blue,
/area/ruins/lavaland/powered/generic)
"I" = (
/obj/structure/chair{
	dir = 4
	},
/turf/open/floor/mineral/titanium/blue,
/area/ruins/lavaland/powered/generic)
"J" = (
/obj/effect/spawner/structure/window/shuttle,
/turf/open/floor/plating{
	initial_gas_mix = "o2=14;n2=23;TEMP=300"
	},
/area/ruins/lavaland/powered/generic)
"L" = (
/obj/machinery/hydroponics/soil,
/obj/item/cultivator,
/turf/open/floor/plating,
/area/ruins/lavaland/powered/generic)
"M" = (
/obj/machinery/portable_atmospherics/canister/oxygen,
/turf/open/floor/plating/asteroid/basalt,
/area/ruins/lavaland/powered/generic)
"P" = (
/turf/template_noop,
/area/template_noop)
"S" = (
/obj/item/clothing/head/helmet/space/orange,
/turf/open/floor/plating/asteroid{
	name = "dirt"
	},
/area/ruins/lavaland/powered/generic)
"X" = (
/obj/structure/rack,
/obj/item/reagent_containers/food/snacks/grown/mushroom/glowshroom,
/obj/item/seeds/tower,
/obj/item/seeds/lavaland/cactus,
/obj/item/seeds/lavaland/porcini,
/obj/item/seeds/lavaland/inocybe,
/obj/item/seeds/lavaland/ember,
/turf/open/floor/plating/asteroid/basalt,
/area/ruins/lavaland/powered/generic)

(1,1,1) = {"
P
P
P
P
P
P
P
P
P
P
P
P
P
P
P
P
"}
(2,1,1) = {"
P
P
P
P
P
P
P
P
P
P
P
s
s
s
P
P
"}
(3,1,1) = {"
P
P
P
P
P
a
a
a
a
a
s
s
s
s
s
P
"}
(4,1,1) = {"
P
P
P
a
a
a
a
a
a
a
a
s
s
s
s
P
"}
(5,1,1) = {"
P
P
a
a
a
c
c
c
t
t
t
t
t
s
s
s
"}
(6,1,1) = {"
P
a
a
a
c
c
L
n
t
v
x
B
t
s
s
s
"}
(7,1,1) = {"
a
a
a
a
c
X
o
o
t
w
y
y
D
s
s
s
"}
(8,1,1) = {"
a
c
c
c
c
f
o
q
o
o
z
C
t
s
s
s
"}
(9,1,1) = {"
a
c
f
i
g
f
f
o
o
o
t
t
t
s
s
s
"}
(10,1,1) = {"
a
c
S
j
g
g
f
f
u
o
A
c
P
s
s
s
"}
(11,1,1) = {"
a
c
e
h
l
c
p
r
c
c
c
c
P
P
s
s
"}
(12,1,1) = {"
a
c
c
k
M
c
c
c
c
a
a
P
P
E
H
E
"}
(13,1,1) = {"
a
a
c
c
c
c
a
a
a
a
P
P
P
F
I
F
"}
(14,1,1) = {"
a
a
a
a
a
a
a
a
a
P
P
P
P
F
I
F
"}
(15,1,1) = {"
P
P
a
a
P
P
P
P
P
P
P
P
P
G
J
G
"}
(16,1,1) = {"
P
P
P
P
P
P
P
P
P
P
P
P
P
P
P
P
"}
