//MAP CONVERTED BY dmm2tgm.py THIS HEADER COMMENT PREVENTS RECONVERSION, DO NOT REMOVE
"aa" = (
/turf/open/floor/plating/asteroid/basalt/lava_land_surface,
/area/external/mining/lavaland/explored)
"ab" = (
/turf/open/lava/smooth/lava_land_surface,
/area/external/mining/lavaland/explored)
"ac" = (
/turf/closed/mineral/volcanic/lava_land_surface,
/area/external/mining/lavaland/explored)
"ad" = (
/turf/closed/wall/r_wall,
/area/ruins/lavaland/unpowered/generic)
"ae" = (
/turf/open/floor/plasteel,
/area/ruins/lavaland/unpowered/generic)
"af" = (
/obj/effect/decal/cleanable/dirt,
/turf/open/floor/plasteel,
/area/ruins/lavaland/unpowered/generic)
"ag" = (
/obj/machinery/door/airlock,
/turf/open/floor/plating,
/area/ruins/lavaland/unpowered/generic)
"ah" = (
/turf/open/floor/plating,
/area/ruins/lavaland/unpowered/generic)
"ai" = (
/obj/effect/decal/cleanable/dirt,
/turf/open/floor/plating,
/area/ruins/lavaland/unpowered/generic)
"aj" = (
/obj/structure/closet/emcloset,
/obj/item/tank/internals/emergency_oxygen,
/obj/item/tank/internals/emergency_oxygen,
/obj/item/clothing/mask/breath,
/obj/item/clothing/mask/breath,
/turf/open/floor/plating,
/area/ruins/lavaland/unpowered/generic)
"ak" = (
/obj/effect/mob_spawn/human/corpse/damaged,
/turf/open/lava/smooth/lava_land_surface,
/area/external/mining/lavaland/explored)
"al" = (
/turf/closed/wall,
/area/ruins/lavaland/unpowered/generic)
"am" = (
/obj/structure/closet/crate,
/obj/effect/spawner/lootdrop/maintenance,
/turf/open/floor/plating,
/area/ruins/lavaland/unpowered/generic)
"an" = (
/obj/effect/mob_spawn/human/corpse/damaged,
/turf/open/floor/plating,
/area/ruins/lavaland/unpowered/generic)
"ao" = (
/obj/machinery/door/airlock/public/glass,
/turf/open/floor/plasteel,
/area/ruins/lavaland/unpowered/generic)
"ap" = (
/obj/effect/decal/cleanable/blood,
/obj/effect/mob_spawn/human/corpse/nanotrasensoldier,
/obj/item/book/manual/wiki/security_space_law,
/turf/open/floor/plasteel,
/area/ruins/lavaland/unpowered/generic)
"aq" = (
/obj/structure/table/wood,
/obj/item/trash/candle,
/turf/open/floor/wood,
/area/ruins/lavaland/unpowered/generic)
"ar" = (
/obj/structure/closet/crate/bin,
/obj/item/paper{
	info = "If you are reading this then you just unpackaged your Fortress in a pill! Simply shake the pill in your hand and place it where you wish to have your desired fortress! Nanotrasen is not responsible for any unfortunate death, maiming, grevious injuries and sudden unexpected live burials. Have a safe and secure day!";
	name = "Paper- Fortress Pill!"
	},
/obj/effect/decal/cleanable/ash,
/obj/item/melee/transforming/energy/sword/pirate,
/turf/open/floor/wood,
/area/ruins/lavaland/unpowered/generic)
"as" = (
/obj/effect/decal/cleanable/dirt,
/turf/open/floor/wood,
/area/ruins/lavaland/unpowered/generic)
"at" = (
/obj/structure/bed,
/obj/item/bedsheet/qm,
/turf/open/floor/wood,
/area/ruins/lavaland/unpowered/generic)
"au" = (
/obj/effect/mob_spawn/human/corpse/pirate,
/obj/effect/decal/cleanable/blood,
/turf/open/floor/wood,
/area/ruins/lavaland/unpowered/generic)
"av" = (
/mob/living/simple_animal/parrot,
/turf/open/floor/wood,
/area/ruins/lavaland/unpowered/generic)
"aw" = (
/obj/item/broken_bottle,
/turf/open/floor/wood,
/area/ruins/lavaland/unpowered/generic)
"ax" = (
/obj/item/coin/diamond,
/obj/item/stack/spacecash/c500,
/obj/item/stack/sheet/mineral/gold,
/turf/open/floor/mineral/silver,
/area/ruins/lavaland/unpowered/generic)
"ay" = (
/obj/structure/closet/crate/engineering/electrical,
/obj/item/pizzabox/meat,
/obj/item/coin/adamantine,
/obj/item/coin/diamond,
/obj/item/coin/silver,
/obj/item/coin/silver,
/obj/item/coin/silver,
/obj/item/stack/spacecash/c1000,
/obj/item/stack/spacecash/c1000,
/obj/item/stack/spacecash/c1000,
/obj/item/reagent_containers/food/drinks/flask/gold,
/obj/item/stack/sheet/mineral/gold,
/obj/item/stack/sheet/mineral/gold,
/obj/item/stack/sheet/mineral/gold,
/obj/effect/spawner/lootdrop/gambling,
/obj/effect/spawner/lootdrop/gambling,
/obj/effect/spawner/lootdrop/gambling,
/turf/open/floor/mineral/gold,
/area/ruins/lavaland/unpowered/generic)
"az" = (
/obj/structure/closet/crate/secure/loot,
/obj/effect/decal/cleanable/dirt,
/turf/open/floor/mineral/silver,
/area/ruins/lavaland/unpowered/generic)
"aA" = (
/obj/effect/mob_spawn/human/corpse/syndicatesoldier,
/obj/effect/decal/cleanable/blood,
/turf/open/floor/plasteel,
/area/ruins/lavaland/unpowered/generic)
"aB" = (
/obj/item/coin/antagtoken,
/turf/open/floor/plasteel,
/area/ruins/lavaland/unpowered/generic)
"aC" = (
/obj/item/newspaper,
/turf/open/floor/wood,
/area/ruins/lavaland/unpowered/generic)
"aD" = (
/obj/structure/falsewall/reinforced,
/turf/open/floor/plating,
/area/ruins/lavaland/unpowered/generic)
"aE" = (
/obj/effect/decal/cleanable/dirt,
/turf/open/floor/mineral/silver,
/area/ruins/lavaland/unpowered/generic)
"aF" = (
/obj/item/coin/diamond,
/obj/item/stack/spacecash/c200,
/obj/item/stack/sheet/mineral/gold,
/obj/item/stack/sheet/mineral/gold,
/turf/open/floor/mineral/silver,
/area/ruins/lavaland/unpowered/generic)
"aG" = (
/obj/structure/closet/crate/secure/loot,
/turf/open/floor/mineral/silver,
/area/ruins/lavaland/unpowered/generic)
"aI" = (
/obj/machinery/door/airlock/security,
/turf/open/floor/plasteel,
/area/ruins/lavaland/unpowered/generic)
"aJ" = (
/obj/machinery/door/airlock/highsecurity,
/obj/structure/barricade/wooden,
/turf/open/floor/plasteel/white,
/area/ruins/lavaland/unpowered/generic)
"aN" = (
/obj/machinery/door/airlock/hatch,
/obj/structure/fans/tiny/invisible,
/turf/open/floor/plating/asteroid/basalt/lava_land_surface,
/area/ruins/lavaland/unpowered/generic)
"aO" = (
/obj/machinery/door/airlock/hatch,
/obj/structure/fans/tiny/invisible,
/turf/open/floor/plasteel,
/area/ruins/lavaland/unpowered/generic)
"aP" = (
/obj/effect/mob_spawn/human/corpse/damaged,
/obj/effect/decal/cleanable/blood,
/turf/open/floor/plasteel,
/area/ruins/lavaland/unpowered/generic)
"aQ" = (
/obj/machinery/door/airlock,
/turf/open/floor/plasteel/white,
/area/ruins/lavaland/unpowered/generic)
"aR" = (
/turf/open/floor/plasteel/white,
/area/ruins/lavaland/unpowered/generic)
"aS" = (
/obj/item/trash/syndi_cakes,
/turf/open/floor/plasteel/white,
/area/ruins/lavaland/unpowered/generic)
"aT" = (
/obj/effect/decal/cleanable/dirt,
/turf/open/floor/plasteel/white,
/area/ruins/lavaland/unpowered/generic)
"aU" = (
/obj/structure/table,
/obj/item/kitchen/fork,
/turf/open/floor/plasteel/white,
/area/ruins/lavaland/unpowered/generic)
"aV" = (
/obj/structure/chair{
	dir = 8
	},
/turf/open/floor/plasteel/white,
/area/ruins/lavaland/unpowered/generic)
"aX" = (
/obj/effect/decal/cleanable/blood/gibs/body,
/turf/open/floor/plasteel,
/area/ruins/lavaland/unpowered/generic)
"aY" = (
/obj/structure/chair,
/turf/open/floor/plasteel/white,
/area/ruins/lavaland/unpowered/generic)
"aZ" = (
/obj/effect/decal/cleanable/blood,
/turf/open/floor/plasteel/white,
/area/ruins/lavaland/unpowered/generic)
"ba" = (
/obj/effect/decal/cleanable/robot_debris,
/obj/item/reagent_containers/glass/bucket,
/turf/open/floor/plasteel/white,
/area/ruins/lavaland/unpowered/generic)
"bc" = (
/obj/machinery/door/airlock,
/turf/open/floor/plasteel,
/area/ruins/lavaland/unpowered/generic)
"bd" = (
/obj/structure/table,
/obj/item/reagent_containers/food/snacks/cubannachos,
/turf/open/floor/plasteel/white,
/area/ruins/lavaland/unpowered/generic)
"be" = (
/obj/structure/table,
/obj/item/reagent_containers/food/snacks/fishandchips,
/obj/item/reagent_containers/food/snacks/fishandchips,
/turf/open/floor/plasteel/white,
/area/ruins/lavaland/unpowered/generic)
"bf" = (
/obj/item/chair,
/obj/effect/mob_spawn/human/corpse/damaged,
/turf/open/floor/plasteel/white,
/area/ruins/lavaland/unpowered/generic)
"bg" = (
/obj/structure/table,
/obj/item/kitchen/rollingpin,
/obj/item/kitchen/knife,
/turf/open/floor/plasteel/white,
/area/ruins/lavaland/unpowered/generic)
"bh" = (
/obj/structure/rack,
/obj/effect/spawner/lootdrop/maintenance,
/turf/open/floor/wood{
	icon_state = "wood-broken6";
	tag = ""
	},
/area/ruins/lavaland/unpowered/generic)
"bi" = (
/obj/structure/table,
/obj/item/toy/toy_xeno,
/obj/item/toy/sword,
/turf/open/floor/wood,
/area/ruins/lavaland/unpowered/generic)
"bj" = (
/turf/open/floor/wood,
/area/ruins/lavaland/unpowered/generic)
"bk" = (
/obj/structure/rack,
/obj/effect/spawner/lootdrop/maintenance,
/turf/open/floor/wood,
/area/ruins/lavaland/unpowered/generic)
"bl" = (
/obj/structure/closet/crate/freezer,
/obj/item/reagent_containers/food/snacks/cubancarp,
/obj/item/reagent_containers/food/snacks/cubannachos,
/obj/item/reagent_containers/food/snacks/cubannachos,
/obj/item/reagent_containers/food/snacks/fishandchips,
/obj/item/reagent_containers/food/snacks/fishandchips,
/obj/item/reagent_containers/food/snacks/fishfingers,
/obj/item/reagent_containers/food/snacks/fishfingers,
/turf/open/floor/plasteel/freezer,
/area/ruins/lavaland/unpowered/generic)
"bm" = (
/obj/machinery/door/airlock/freezer,
/turf/open/floor/plasteel/freezer,
/area/ruins/lavaland/unpowered/generic)
"bn" = (
/obj/effect/decal/cleanable/blood/gibs/limb,
/turf/open/floor/plasteel/white,
/area/ruins/lavaland/unpowered/generic)
"bo" = (
/obj/item/trash/tray,
/turf/open/floor/plasteel/white,
/area/ruins/lavaland/unpowered/generic)
"bp" = (
/obj/item/trash/cheesie,
/turf/open/floor/plasteel/white,
/area/ruins/lavaland/unpowered/generic)
"bq" = (
/obj/structure/closet/crate/freezer,
/obj/item/reagent_containers/food/snacks/carpmeat,
/obj/item/reagent_containers/food/snacks/carpmeat,
/obj/item/reagent_containers/food/snacks/carpmeat,
/obj/item/reagent_containers/food/snacks/carpmeat,
/obj/item/reagent_containers/food/snacks/carpmeat,
/obj/item/reagent_containers/food/snacks/carpmeat,
/obj/item/reagent_containers/food/condiment/flour,
/obj/item/reagent_containers/food/condiment/flour,
/turf/open/floor/plasteel/white,
/area/ruins/lavaland/unpowered/generic)
"br" = (
/obj/effect/decal/cleanable/dirt,
/turf/open/floor/wood{
	icon_state = "wood-broken4";
	tag = ""
	},
/area/ruins/lavaland/unpowered/generic)
"bs" = (
/obj/effect/decal/cleanable/dirt,
/turf/open/floor/wood{
	icon_state = "wood-broken6";
	tag = ""
	},
/area/ruins/lavaland/unpowered/generic)
"bt" = (
/obj/item/toy/gun/toyglock,
/turf/open/floor/wood{
	icon_state = "wood-broken6";
	tag = ""
	},
/area/ruins/lavaland/unpowered/generic)
"bu" = (
/obj/structure/table_frame,
/turf/open/floor/wood,
/area/ruins/lavaland/unpowered/generic)
"bv" = (
/obj/effect/mob_spawn/human/corpse/damaged,
/obj/effect/decal/cleanable/blood,
/turf/open/floor/wood,
/area/ruins/lavaland/unpowered/generic)
"bw" = (
/turf/open/floor/wood{
	icon_state = "wood-broken6";
	tag = ""
	},
/area/ruins/lavaland/unpowered/generic)
"bx" = (
/obj/item/stack/sheet/metal,
/turf/open/floor/plating,
/area/ruins/lavaland/unpowered/generic)
"by" = (
/turf/open/floor/wood{
	icon_state = "wood-broken4";
	tag = ""
	},
/area/ruins/lavaland/unpowered/generic)
"bz" = (
/obj/machinery/door/airlock/wood,
/turf/open/floor/wood,
/area/ruins/lavaland/unpowered/generic)
"bA" = (
/obj/machinery/door/airlock/wood,
/obj/effect/decal/cleanable/blood,
/turf/open/floor/wood,
/area/ruins/lavaland/unpowered/generic)
"bB" = (
/obj/structure/closet/wardrobe/pink,
/obj/item/clothing/under/costume/pirate,
/obj/item/clothing/under/costume/pirate,
/obj/item/clothing/shoes/jackboots,
/obj/item/clothing/shoes/jackboots,
/obj/item/clothing/glasses/eyepatch,
/obj/item/clothing/glasses/eyepatch,
/obj/item/clothing/head/pirate/bandana,
/obj/item/clothing/head/pirate/bandana,
/turf/open/floor/wood,
/area/ruins/lavaland/unpowered/generic)
"bC" = (
/obj/structure/bed,
/obj/item/bedsheet,
/turf/open/floor/wood,
/area/ruins/lavaland/unpowered/generic)
"bD" = (
/obj/effect/decal/cleanable/blood/tracks,
/turf/open/floor/wood,
/area/ruins/lavaland/unpowered/generic)
"bE" = (
/obj/structure/bed,
/obj/item/bedsheet,
/obj/item/toy/plush/carpplushie,
/turf/open/floor/wood,
/area/ruins/lavaland/unpowered/generic)
"bF" = (
/obj/structure/closet/wardrobe/pink,
/obj/item/clothing/under/costume/pirate,
/obj/item/clothing/under/costume/pirate,
/obj/item/clothing/shoes/jackboots,
/obj/item/clothing/shoes/jackboots,
/obj/item/clothing/glasses/eyepatch,
/obj/item/clothing/glasses/eyepatch,
/obj/item/clothing/head/pirate/bandana,
/obj/item/clothing/head/pirate/bandana,
/obj/item/toy/katana,
/turf/open/floor/wood,
/area/ruins/lavaland/unpowered/generic)
"bG" = (
/obj/effect/decal/cleanable/dirt,
/obj/effect/mob_spawn/human/corpse/damaged,
/obj/effect/decal/cleanable/blood,
/turf/open/floor/wood,
/area/ruins/lavaland/unpowered/generic)
"bH" = (
/obj/item/toy/plush/stuffedmonkey,
/turf/open/floor/wood,
/area/ruins/lavaland/unpowered/generic)
"bI" = (
/obj/structure/bed,
/turf/open/floor/wood,
/area/ruins/lavaland/unpowered/generic)
"bJ" = (
/obj/item/paper{
	info = "Ello there matey! Congratulations on fidning mi' cove! Trapped up in this hellscape of... shit. If you're reading this message you probably know me as the great Cuggan who slayed the terrible legion, but if you don't... than I'm probably one of them."
	},
/turf/open/floor/plasteel/white,
/area/ruins/lavaland/unpowered/generic)
"mz" = (
/obj/effect/decal/cleanable/blood,
/turf/open/floor/plating/lavaland_baseturf,
/area/external/mining/lavaland/explored)
"nf" = (
/obj/effect/mob_spawn/human/corpse/damaged,
/turf/open/floor/plating/lavaland_baseturf,
/area/external/mining/lavaland/explored)
"qC" = (
/turf/open/floor/plating/lavaland_baseturf,
/area/external/mining/lavaland/explored)
"tV" = (
/obj/effect/decal/cleanable/blood/tracks,
/turf/open/floor/plating/lavaland_baseturf,
/area/external/mining/lavaland/explored)

(1,1,1) = {"
aa
ab
ab
ab
ab
ab
ab
ab
ab
ab
ab
ak
ab
ab
ab
ab
ab
ab
ab
ab
ab
ab
ab
ac
ac
"}
(2,1,1) = {"
ab
ab
ab
ab
ab
ab
ab
ab
ab
ab
aa
ab
aa
ab
ab
ab
ac
ac
ak
aa
ab
ab
ac
ab
ab
"}
(3,1,1) = {"
ab
ab
ab
ac
ab
ab
ab
ac
ab
ab
ab
ab
ab
ak
ab
ab
ab
ab
ab
ab
ab
ab
ab
ab
ab
"}
(4,1,1) = {"
ab
aa
ab
ab
ab
ab
ak
ab
ab
ab
nf
ab
ab
ab
ab
ab
ak
ab
aa
ab
ab
ab
ab
ab
ab
"}
(5,1,1) = {"
ab
ab
ab
ab
ab
ab
ab
ac
ab
ab
ab
qC
tV
mz
ab
ab
ab
ab
ab
aa
aa
ab
ab
aa
ab
"}
(6,1,1) = {"
ab
ab
ac
ab
ab
ab
ab
ab
aa
ab
ad
aN
aN
ad
ad
ad
ad
ad
ad
ad
ad
aa
ab
ab
ab
"}
(7,1,1) = {"
ab
ab
ab
ab
ab
aa
ab
aa
ab
aa
ad
ae
aP
ad
bh
bj
bt
bk
al
bB
ad
ad
aa
ab
ab
"}
(8,1,1) = {"
ab
ab
ab
aa
ad
ad
ad
ad
ad
ad
ad
aO
aO
ad
bi
as
bu
by
bz
as
bH
ad
ab
ab
ab
"}
(9,1,1) = {"
ab
ab
ab
ab
ad
ae
af
af
ae
af
aI
af
af
bc
bj
br
bv
bw
al
bC
bC
ad
aa
ac
ab
"}
(10,1,1) = {"
ab
ab
ab
aa
ad
af
al
ao
al
ao
al
aP
af
al
bk
bs
bj
as
al
al
al
ad
aa
ab
ab
"}
(11,1,1) = {"
ab
ab
aa
aa
ad
ae
al
ae
al
aA
al
af
ae
al
al
al
bw
ah
al
bB
as
ad
ab
ab
ab
"}
(12,1,1) = {"
ab
ab
ab
aa
ad
af
al
ap
al
aB
al
af
aX
al
bl
al
bj
an
bA
bD
bD
ad
ab
ab
ab
"}
(13,1,1) = {"
ab
ab
ab
ab
ad
ag
ad
ad
ad
ad
ad
aQ
al
al
bm
al
ai
by
al
bE
bI
ad
ab
ab
ab
"}
(14,1,1) = {"
ac
ab
ab
aa
ad
ah
ad
aq
as
as
aJ
aR
bJ
aT
bn
al
ai
ah
al
al
al
ad
aa
ab
aa
"}
(15,1,1) = {"
ab
ab
ab
ab
ad
ai
ad
ar
au
aC
ad
aS
aY
bd
bo
al
bx
ah
al
bF
as
ad
aa
ab
ab
"}
(16,1,1) = {"
ab
ab
ab
aa
ad
ai
ad
as
av
as
ad
aT
aZ
be
aT
al
ah
ah
bz
bj
bj
ad
ab
ab
ab
"}
(17,1,1) = {"
ab
ab
ab
aa
ad
ai
ad
at
aw
as
ad
aU
ba
bf
aR
al
ah
af
al
bG
bC
ad
ab
ab
ac
"}
(18,1,1) = {"
ab
ab
aa
aa
ad
ag
ad
ad
ad
aD
ad
aV
aR
aR
bp
al
af
af
al
al
al
ad
ab
ab
ab
"}
(19,1,1) = {"
ab
aa
ab
aa
ad
ai
am
ad
ax
aE
ad
aT
aT
bg
bq
al
ae
ae
ag
ai
am
ad
aa
aa
ab
"}
(20,1,1) = {"
ab
ab
ab
ab
ad
ai
an
ad
ay
aF
ad
aQ
al
al
al
al
bc
al
al
aj
ad
ad
aa
ab
ab
"}
(21,1,1) = {"
ab
ab
ab
aa
ad
aj
ai
ad
az
aG
ad
ae
af
ae
ae
af
ae
ad
ad
ad
ad
aa
ab
ab
ab
"}
(22,1,1) = {"
ab
ab
ab
ab
ad
ad
ad
ad
ad
ad
ad
ad
ad
ad
ad
ad
ad
ad
ab
ab
aa
ab
ab
ab
ab
"}
(23,1,1) = {"
ab
ab
ab
aa
aa
ab
ab
aa
ab
aa
aa
ab
ab
aa
aa
ab
aa
ab
aa
ab
ab
ab
ab
ab
ab
"}
(24,1,1) = {"
ab
ac
ab
ab
ab
ab
ab
ab
ab
ab
ab
ab
ab
ab
ab
ab
ab
ab
ac
ac
ab
ab
aa
aa
ab
"}
(25,1,1) = {"
ab
ab
ab
ab
ab
ab
ac
ab
ab
ab
ab
ab
ab
ab
ab
ab
ab
ab
ab
ab
ab
ab
ab
ab
ab
"}
