//MAP CONVERTED BY dmm2tgm.py THIS HEADER COMMENT PREVENTS RECONVERSION, DO NOT REMOVE
"a" = (
/obj/structure/stone_tile/block/burnt,
/obj/structure/stone_tile{
	dir = 4
	},
/obj/structure/stone_tile{
	dir = 1
	},
/turf/open/lava/smooth/lava_land_surface,
/area/external/mining/lavaland/explored)
"b" = (
/obj/structure/mineral_door/transparent/diamond{
	sheetAmount = 1
	},
/turf/open/floor/mineral/gold,
/area/ruins/lavaland/powered/kinggoat_lair)
"c" = (
/obj/item/hatchet,
/turf/open/floor/carpet/red,
/area/ruins/lavaland/powered/kinggoat_lair)
"d" = (
/obj/structure/stone_tile/surrounding_tile{
	dir = 8
	},
/turf/open/lava/smooth/lava_land_surface,
/area/external/mining/lavaland/explored)
"e" = (
/obj/effect/decal/cleanable/blood/tracks{
	dir = 4
	},
/turf/open/floor/carpet/cyan,
/area/ruins/lavaland/powered/kinggoat_lair)
"f" = (
/mob/living/simple_animal/hostile/retaliate/goat,
/turf/open/floor/carpet/cyan,
/area/ruins/lavaland/powered/kinggoat_lair)
"g" = (
/obj/effect/decal/cleanable/blood/old,
/mob/living/simple_animal/hostile/retaliate/goat,
/turf/open/floor/carpet/cyan,
/area/ruins/lavaland/powered/kinggoat_lair)
"h" = (
/turf/closed/wall/mineral/gold,
/area/ruins/lavaland/powered/kinggoat_lair)
"i" = (
/obj/structure/bonfire/prelit,
/turf/open/floor/carpet/cyan,
/area/ruins/lavaland/powered/kinggoat_lair)
"j" = (
/obj/structure/bonfire/prelit,
/turf/open/floor/carpet/red,
/area/ruins/lavaland/powered/kinggoat_lair)
"k" = (
/obj/structure/stone_tile/block{
	dir = 1
	},
/obj/structure/stone_tile,
/turf/open/lava/smooth/lava_land_surface,
/area/external/mining/lavaland/explored)
"m" = (
/turf/open/floor/carpet/cyan,
/area/ruins/lavaland/powered/kinggoat_lair)
"n" = (
/turf/open/floor/carpet/red,
/area/ruins/lavaland/powered/kinggoat_lair)
"o" = (
/turf/open/floor/plating/asteroid/basalt/lava_land_surface,
/area/external/mining/lavaland/explored)
"p" = (
/turf/template_noop,
/area/template_noop)
"q" = (
/obj/effect/decal/cleanable/blood/old,
/mob/living/simple_animal/hostile/retaliate/goat,
/turf/open/floor/carpet/red,
/area/ruins/lavaland/powered/kinggoat_lair)
"r" = (
/obj/structure/stone_tile/slab/cracked,
/turf/open/lava/smooth/lava_land_surface,
/area/external/mining/lavaland/explored)
"s" = (
/turf/closed/wall/r_wall/rust,
/area/ruins/lavaland/powered/kinggoat_lair)
"t" = (
/obj/structure/mineral_door/iron,
/obj/structure/fans/tiny/invisible,
/turf/open/floor/carpet/red,
/area/ruins/lavaland/powered/kinggoat_lair)
"u" = (
/obj/structure/ladder/unbreakable{
	desc = "This seems to be the ladder to the King of Goats lair. Looks to be a one way trip...";
	id = "goatlayer";
	name = "Ladder to the King of Goats Lair"
	},
/obj/item/gps/internal{
	desc = "Something about this signal seems a bit more rich then the average signal.";
	gpstag = "Bleating Signal";
	name = "kinggoat"
	},
/turf/open/floor/mineral/diamond,
/area/ruins/lavaland/powered/kinggoat_lair)
"v" = (
/obj/effect/decal/cleanable/blood/old,
/turf/open/floor/mineral/diamond,
/area/ruins/lavaland/powered/kinggoat_lair)
"x" = (
/mob/living/simple_animal/hostile/retaliate/goat,
/turf/open/floor/plating/asteroid/basalt/lava_land_surface,
/area/external/mining/lavaland/explored)
"y" = (
/obj/structure/mineral_door/silver,
/turf/open/floor/carpet/red,
/area/ruins/lavaland/powered/kinggoat_lair)
"z" = (
/turf/template_noop,
/area/external/mining/lavaland/explored)
"A" = (
/turf/closed/mineral/volcanic/lava_land_surface,
/area/ruins/lavaland/powered/kinggoat_lair)
"B" = (
/obj/item/paper/crumpled{
	info = "Lest ye be prepared, abandon all hope ye who enter here.";
	name = "Wise Man's Warning"
	},
/turf/open/floor/mineral/gold,
/area/ruins/lavaland/powered/kinggoat_lair)
"C" = (
/obj/effect/decal/cleanable/blood/old,
/obj/effect/mob_spawn/human/miner,
/turf/open/floor/carpet/red,
/area/ruins/lavaland/powered/kinggoat_lair)
"D" = (
/turf/open/lava/smooth/lava_land_surface,
/area/external/mining/lavaland/explored)
"E" = (
/obj/effect/decal/cleanable/blood/splatter,
/turf/open/floor/carpet/cyan,
/area/ruins/lavaland/powered/kinggoat_lair)
"F" = (
/obj/structure/stone_tile{
	dir = 1
	},
/turf/open/lava/smooth/lava_land_surface,
/area/external/mining/lavaland/explored)
"G" = (
/obj/effect/decal/cleanable/blood/old,
/obj/item/melee/spear,
/mob/living/simple_animal/hostile/retaliate/goat,
/turf/open/floor/wood,
/area/ruins/lavaland/powered/kinggoat_lair)
"H" = (
/turf/closed/mineral/volcanic/lava_land_surface,
/area/external/mining/lavaland/explored)
"I" = (
/obj/structure/stone_tile{
	dir = 8
	},
/obj/structure/stone_tile{
	dir = 4
	},
/obj/structure/stone_tile{
	dir = 1
	},
/turf/open/lava/smooth/lava_land_surface,
/area/external/mining/lavaland/explored)
"J" = (
/obj/structure/stone_tile/surrounding_tile{
	dir = 4
	},
/turf/open/lava/smooth/lava_land_surface,
/area/external/mining/lavaland/explored)
"K" = (
/obj/structure/stone_tile{
	dir = 4
	},
/turf/open/lava/smooth/lava_land_surface,
/area/external/mining/lavaland/explored)
"L" = (
/obj/effect/decal/cleanable/blood/tracks,
/turf/open/floor/carpet/cyan,
/area/ruins/lavaland/powered/kinggoat_lair)
"M" = (
/obj/structure/stone_tile{
	dir = 1
	},
/obj/structure/stone_tile{
	dir = 4
	},
/obj/structure/stone_tile,
/turf/open/lava/smooth/lava_land_surface,
/area/external/mining/lavaland/explored)
"N" = (
/turf/closed/wall/r_wall,
/area/ruins/lavaland/powered/kinggoat_lair)
"O" = (
/obj/structure/bonfire/prelit,
/turf/open/floor/wood,
/area/ruins/lavaland/powered/kinggoat_lair)
"P" = (
/turf/open/floor/mineral/gold,
/area/ruins/lavaland/powered/kinggoat_lair)
"Q" = (
/obj/structure/stone_tile/slab/burnt,
/turf/open/lava/smooth/lava_land_surface,
/area/external/mining/lavaland/explored)
"R" = (
/obj/structure/stone_tile/surrounding_tile,
/turf/open/lava/smooth/lava_land_surface,
/area/external/mining/lavaland/explored)
"S" = (
/turf/open/floor/mineral/diamond,
/area/ruins/lavaland/powered/kinggoat_lair)
"T" = (
/obj/effect/decal/cleanable/blood/tracks{
	dir = 10
	},
/turf/open/floor/carpet/cyan,
/area/ruins/lavaland/powered/kinggoat_lair)
"U" = (
/turf/closed/wall/mineral/silver,
/area/ruins/lavaland/powered/kinggoat_lair)
"V" = (
/obj/effect/decal/cleanable/blood/old,
/turf/open/floor/carpet/cyan,
/area/ruins/lavaland/powered/kinggoat_lair)
"W" = (
/turf/open/floor/wood,
/area/ruins/lavaland/powered/kinggoat_lair)
"X" = (
/turf/open/lava/smooth/lava_land_surface)
"Y" = (
/obj/effect/decal/cleanable/blood/old,
/turf/open/floor/carpet/red,
/area/ruins/lavaland/powered/kinggoat_lair)
"Z" = (
/obj/effect/decal/cleanable/blood/old,
/obj/effect/mob_spawn/human/miner,
/turf/open/floor/carpet/cyan,
/area/ruins/lavaland/powered/kinggoat_lair)

(1,1,1) = {"
p
p
p
p
p
p
H
H
H
H
H
H
H
p
p
p
p
p
p
p
p
p
p
"}
(2,1,1) = {"
p
p
p
H
H
H
H
H
H
H
H
H
H
H
H
H
H
p
p
p
p
p
p
"}
(3,1,1) = {"
p
p
p
p
p
H
H
D
D
D
D
D
H
H
H
H
H
H
H
p
p
p
p
"}
(4,1,1) = {"
p
p
H
H
H
H
D
D
D
D
D
D
H
H
H
D
D
D
H
p
p
p
p
"}
(5,1,1) = {"
p
p
H
H
H
H
N
N
s
s
N
N
s
H
H
D
r
D
K
D
D
H
p
"}
(6,1,1) = {"
p
D
D
H
H
H
N
m
m
m
m
m
s
s
s
N
N
D
F
K
D
H
p
"}
(7,1,1) = {"
p
D
D
H
D
H
s
m
Z
L
L
T
N
O
W
W
s
A
D
D
o
o
p
"}
(8,1,1) = {"
p
p
D
H
H
s
s
m
m
m
m
e
N
N
W
W
s
N
D
D
x
o
o
"}
(9,1,1) = {"
p
p
D
H
H
N
U
U
h
U
U
E
f
y
G
W
W
N
d
J
o
o
o
"}
(10,1,1) = {"
p
H
H
H
H
N
U
S
P
P
U
i
Y
y
n
n
Y
t
k
a
o
o
o
"}
(11,1,1) = {"
H
H
H
D
H
N
h
P
S
P
h
n
n
N
n
C
n
N
H
H
H
o
o
"}
(12,1,1) = {"
H
H
D
D
H
N
U
P
u
B
b
Y
n
s
j
n
n
s
H
H
H
H
H
"}
(13,1,1) = {"
H
H
D
D
D
N
h
P
v
P
h
n
n
N
n
c
n
N
d
D
H
H
o
"}
(14,1,1) = {"
p
H
H
H
H
N
U
S
P
P
U
i
n
y
n
q
Y
t
Q
I
M
o
o
"}
(15,1,1) = {"
p
H
H
H
H
s
U
U
h
U
U
m
V
y
W
W
W
s
Q
D
D
o
x
"}
(16,1,1) = {"
p
p
z
H
H
s
s
m
m
m
g
m
s
s
W
W
s
s
R
D
D
o
o
"}
(17,1,1) = {"
p
X
D
D
H
H
s
m
m
m
m
m
s
O
W
W
s
H
D
D
H
H
o
"}
(18,1,1) = {"
p
X
D
D
H
H
s
m
m
m
m
m
N
N
N
N
N
H
H
H
p
p
p
"}
(19,1,1) = {"
p
X
D
D
H
H
s
s
N
N
N
N
N
H
H
D
D
D
D
H
H
p
p
"}
(20,1,1) = {"
p
X
D
H
H
H
H
H
H
H
H
H
H
H
D
D
D
D
D
H
H
p
p
"}
(21,1,1) = {"
p
p
H
H
H
D
H
D
D
D
D
H
H
H
D
D
H
H
H
H
H
p
p
"}
(22,1,1) = {"
p
p
H
H
H
H
H
H
D
D
D
H
H
p
H
H
H
H
H
p
p
p
p
"}
(23,1,1) = {"
p
p
p
p
p
H
H
H
H
H
H
H
H
p
p
p
p
p
p
p
p
p
p
"}
(24,1,1) = {"
p
p
p
p
p
p
p
H
H
H
H
H
p
p
p
p
p
p
p
p
p
p
p
"}
