//MAP CONVERTED BY dmm2tgm.py THIS HEADER COMMENT PREVENTS RECONVERSION, DO NOT REMOVE
"av" = (
/obj/item/flashlight/flare/torch,
/obj/effect/spawner/lootdrop/mob/marrow_weaver,
/turf/open/floor/plating/asteroid/basalt/lava_land_surface,
/area/ruins/lavaland/unpowered/generic)
"bd" = (
/obj/item/flashlight/flare/torch,
/obj/effect/spawner/lootdrop/mob/marrow_weaver,
/obj/structure/spider/stickyweb,
/turf/open/floor/plating/asteroid/basalt/lava_land_surface,
/area/ruins/lavaland/unpowered/generic)
"bh" = (
/turf/open/floor/plating/asteroid/basalt/lava_land_surface,
/area/ruins/lavaland/unpowered/generic)
"cf" = (
/obj/effect/turf_decal/sand,
/obj/item/kitchen/knife/combat/bone,
/turf/open/floor/plasteel/lavaland,
/area/ruins/lavaland/unpowered/generic)
"cK" = (
/obj/item/reagent_containers/food/snacks/spidereggs,
/obj/structure/spider/stickyweb,
/obj/structure/spider/stickyweb,
/turf/open/floor/plating/asteroid/basalt/lava_land_surface,
/area/ruins/lavaland/unpowered/generic)
"cR" = (
/turf/closed/mineral/random/high_chance/volcanic,
/area/ruins/lavaland/unpowered/generic)
"dV" = (
/obj/structure/table,
/obj/effect/turf_decal/sand,
/obj/item/melee/spear/bonespear,
/turf/open/floor/plasteel/lavaland,
/area/ruins/lavaland/unpowered/generic)
"ed" = (
/obj/effect/turf_decal/sand,
/obj/item/flashlight/flare/torch,
/turf/open/floor/plasteel/lavaland,
/area/external/mining/lavaland/explored)
"fQ" = (
/obj/item/reagent_containers/spray/spraytan,
/obj/effect/turf_decal/sand,
/obj/effect/spawner/lootdrop/mob/marrow_weaver,
/turf/open/floor/plasteel/lavaland,
/area/ruins/lavaland/unpowered/generic)
"gh" = (
/obj/structure/spider/stickyweb,
/obj/structure/spider/stickyweb,
/turf/open/floor/plasteel/lavaland,
/area/ruins/lavaland/unpowered/generic)
"gi" = (
/obj/structure/spider/stickyweb,
/obj/structure/spider/stickyweb,
/turf/open/floor/plating/asteroid/basalt/lava_land_surface,
/area/ruins/lavaland/unpowered/generic)
"gl" = (
/obj/item/storage/firstaid/toxin,
/turf/open/floor/plating/asteroid/basalt/lava_land_surface,
/area/ruins/lavaland/unpowered/generic)
"hx" = (
/obj/structure/spider/stickyweb,
/obj/effect/mob_spawn/human/skeleton,
/turf/open/floor/plating/asteroid/basalt/lava_land_surface,
/area/ruins/lavaland/unpowered/generic)
"hR" = (
/obj/effect/mob_spawn/human/corpse/pirate,
/obj/item/melee/transforming/energy/sword/pirate,
/obj/effect/turf_decal/sand,
/obj/effect/spawner/lootdrop/mob/marrow_weaver,
/obj/structure/spider/stickyweb,
/turf/open/floor/plasteel/lavaland,
/area/ruins/lavaland/unpowered/generic)
"ic" = (
/obj/item/reagent_containers/food/snacks/spiderleg,
/obj/structure/spider/stickyweb,
/turf/open/floor/plating/asteroid/basalt/lava_land_surface,
/area/ruins/lavaland/unpowered/generic)
"jy" = (
/turf/open/floor/plating/asteroid/basalt/lava_land_surface,
/area/external/mining/lavaland/explored)
"lt" = (
/obj/item/gun/energy/kinetic_accelerator,
/obj/item/borg/upgrade/modkit/trigger_guard,
/obj/item/borg/upgrade/modkit/chassis_mod/orange,
/obj/structure/spider/stickyweb,
/obj/structure/spider/stickyweb,
/turf/open/floor/plating/asteroid/basalt/lava_land_surface,
/area/ruins/lavaland/unpowered/generic)
"lH" = (
/obj/effect/turf_decal/sand,
/obj/structure/spider/stickyweb,
/turf/open/floor/plasteel/lavaland,
/area/ruins/lavaland/unpowered/generic)
"oF" = (
/obj/effect/turf_decal/sand,
/obj/effect/spawner/lootdrop/mob/marrow_weaver,
/obj/structure/spider/cocoon,
/turf/open/floor/plasteel/lavaland,
/area/ruins/lavaland/unpowered/generic)
"pq" = (
/obj/item/reagent_containers/food/snacks/spidereggs,
/obj/effect/spawner/lootdrop/mob/marrow_weaver,
/obj/structure/spider/stickyweb,
/turf/open/floor/plating/asteroid/basalt/lava_land_surface,
/area/ruins/lavaland/unpowered/generic)
"qi" = (
/obj/effect/mob_spawn/human/corpse/russian/ranged/trooper,
/obj/effect/turf_decal/sand,
/obj/structure/spider/stickyweb,
/turf/open/floor/plasteel/lavaland,
/area/ruins/lavaland/unpowered/generic)
"qR" = (
/obj/structure/table,
/obj/item/stack/sheet/animalhide/weaver_chitin,
/obj/effect/turf_decal/sand,
/turf/open/floor/plasteel/lavaland,
/area/ruins/lavaland/unpowered/generic)
"sQ" = (
/obj/effect/turf_decal/sand,
/obj/item/flashlight/flare/torch,
/turf/open/floor/plasteel/lavaland,
/area/ruins/lavaland/unpowered/generic)
"to" = (
/obj/structure/spider/stickyweb,
/turf/open/floor/plasteel/lavaland,
/area/ruins/lavaland/unpowered/generic)
"tT" = (
/obj/effect/turf_decal/sand,
/obj/effect/spawner/lootdrop/mob/marrow_weaver,
/turf/open/floor/plasteel/lavaland,
/area/ruins/lavaland/unpowered/generic)
"vk" = (
/obj/item/pickaxe/silver,
/turf/open/floor/plating/asteroid/basalt/lava_land_surface,
/area/ruins/lavaland/unpowered/generic)
"vl" = (
/obj/effect/turf_decal/sand,
/obj/structure/spider/stickyweb,
/obj/structure/spider/stickyweb,
/obj/structure/spider/cocoon,
/turf/open/floor/plasteel/lavaland,
/area/ruins/lavaland/unpowered/generic)
"wH" = (
/turf/closed/mineral/random/high_chance/volcanic,
/area/external/mining/lavaland/explored)
"wY" = (
/obj/item/flashlight/flare/torch,
/obj/structure/spider/stickyweb,
/turf/open/floor/plating/asteroid/basalt/lava_land_surface,
/area/ruins/lavaland/unpowered/generic)
"xw" = (
/obj/structure/spider/stickyweb,
/turf/open/floor/plating/asteroid/basalt/lava_land_surface,
/area/ruins/lavaland/unpowered/generic)
"za" = (
/obj/effect/mob_spawn/human/skeleton,
/obj/item/melee/spear/bonespear,
/obj/item/reagent_containers/food/snacks/spidereggs,
/obj/effect/spawner/lootdrop/mob/marrow_weaver,
/obj/structure/spider/stickyweb,
/turf/open/floor/plating/asteroid/basalt/lava_land_surface,
/area/ruins/lavaland/unpowered/generic)
"zp" = (
/obj/effect/mob_spawn/human/corpse/russian/ranged/trooper,
/obj/effect/turf_decal/sand,
/obj/item/gun/ballistic/rifle/boltaction,
/obj/structure/spider/stickyweb,
/turf/open/floor/plasteel/lavaland,
/area/ruins/lavaland/unpowered/generic)
"zU" = (
/turf/closed/mineral/random/volcanic/hard,
/area/ruins/lavaland/unpowered/generic)
"zW" = (
/obj/effect/spawner/lootdrop/mob/marrow_weaver,
/obj/structure/spider/stickyweb,
/obj/structure/spider/cocoon,
/turf/open/floor/plating/asteroid/basalt/lava_land_surface,
/area/ruins/lavaland/unpowered/generic)
"Ai" = (
/obj/structure/mineral_door/sandstone,
/turf/open/floor/plasteel,
/area/ruins/lavaland/unpowered/generic)
"As" = (
/obj/effect/spawner/lootdrop/mob/marrow_weaver,
/obj/structure/spider/stickyweb,
/turf/open/floor/plating/asteroid/basalt/lava_land_surface,
/area/ruins/lavaland/unpowered/generic)
"Dd" = (
/obj/effect/mob_spawn/human/skeleton,
/obj/structure/spider/stickyweb,
/obj/structure/spider/stickyweb,
/turf/open/floor/plating/asteroid/basalt/lava_land_surface,
/area/ruins/lavaland/unpowered/generic)
"Dx" = (
/obj/effect/mob_spawn/human/corpse/nanotrasensoldier,
/obj/effect/turf_decal/sand,
/obj/structure/spider/stickyweb,
/turf/open/floor/plasteel/lavaland,
/area/ruins/lavaland/unpowered/generic)
"Dy" = (
/obj/effect/mob_spawn/human/skeleton,
/obj/structure/spider/stickyweb,
/turf/open/floor/plating/asteroid/basalt/lava_land_surface,
/area/ruins/lavaland/unpowered/generic)
"DK" = (
/obj/effect/mob_spawn/human/corpse/nanotrasensoldier,
/obj/item/melee/classic_baton,
/obj/item/gun/ballistic/shotgun/doublebarrel,
/obj/structure/spider/stickyweb,
/turf/open/floor/plating/asteroid/basalt/lava_land_surface,
/area/ruins/lavaland/unpowered/generic)
"Em" = (
/obj/item/reagent_containers/food/snacks/spidereggs,
/obj/structure/spider/stickyweb,
/obj/structure/spider/stickyweb,
/obj/structure/spider/cocoon,
/turf/open/floor/plating/asteroid/basalt/lava_land_surface,
/area/ruins/lavaland/unpowered/generic)
"Fj" = (
/obj/effect/spawner/lootdrop/mob/marrow_weaver,
/turf/open/floor/plating/asteroid/basalt/lava_land_surface,
/area/ruins/lavaland/unpowered/generic)
"FZ" = (
/turf/closed/wall/mineral/sandstone,
/area/external/mining/lavaland/explored)
"He" = (
/obj/effect/mob_spawn/human/skeleton,
/obj/item/clothing/suit/armor/bone,
/obj/item/fireaxe/boneaxe,
/obj/structure/spider/stickyweb,
/obj/structure/spider/cocoon,
/turf/open/floor/plating/asteroid/basalt/lava_land_surface,
/area/ruins/lavaland/unpowered/generic)
"Hl" = (
/obj/effect/turf_decal/sand,
/obj/effect/spawner/lootdrop/mob/marrow_weaver,
/obj/structure/spider/stickyweb,
/turf/open/floor/plasteel/lavaland,
/area/ruins/lavaland/unpowered/generic)
"HM" = (
/turf/template_noop,
/area/template_noop)
"If" = (
/obj/effect/turf_decal/sand,
/turf/open/floor/plasteel/lavaland,
/area/ruins/lavaland/unpowered/generic)
"IH" = (
/obj/item/reagent_containers/food/snacks/spidereggs,
/obj/effect/spawner/lootdrop/mob/marrow_weaver,
/obj/structure/spider/stickyweb,
/obj/structure/spider/cocoon,
/turf/open/floor/plating/asteroid/basalt/lava_land_surface,
/area/ruins/lavaland/unpowered/generic)
"IP" = (
/turf/closed/wall/mineral/sandstone,
/area/ruins/lavaland/unpowered/generic)
"Ji" = (
/obj/effect/mob_spawn/human/corpse/syndicatesoldier,
/obj/effect/turf_decal/sand,
/obj/structure/spider/stickyweb,
/obj/structure/spider/cocoon,
/turf/open/floor/plasteel/lavaland,
/area/ruins/lavaland/unpowered/generic)
"Jj" = (
/obj/effect/turf_decal/sand,
/obj/item/reagent_containers/food/snacks/spidereggs,
/obj/structure/spider/stickyweb,
/turf/open/floor/plasteel/lavaland,
/area/ruins/lavaland/unpowered/generic)
"JY" = (
/obj/item/storage/firstaid/regular,
/turf/open/floor/plating/asteroid/basalt/lava_land_surface,
/area/ruins/lavaland/unpowered/generic)
"Kj" = (
/obj/effect/turf_decal/sand,
/obj/effect/spawner/lootdrop/mob/marrow_weaver,
/obj/structure/spider/stickyweb,
/obj/structure/spider/stickyweb,
/turf/open/floor/plasteel/lavaland,
/area/ruins/lavaland/unpowered/generic)
"KT" = (
/obj/effect/turf_decal/sand,
/obj/item/reagent_containers/food/snacks/spidereggs,
/obj/item/reagent_containers/food/snacks/spiderleg,
/obj/effect/spawner/lootdrop/mob/marrow_weaver,
/obj/structure/spider/stickyweb,
/turf/open/floor/plasteel/lavaland,
/area/ruins/lavaland/unpowered/generic)
"KW" = (
/obj/structure/bed,
/obj/effect/mob_spawn/human/skeleton,
/obj/effect/turf_decal/sand,
/turf/open/floor/plasteel/lavaland,
/area/ruins/lavaland/unpowered/generic)
"Lc" = (
/obj/effect/spawner/lootdrop/mob/marrow_weaver,
/obj/structure/spider/stickyweb,
/obj/structure/spider/stickyweb,
/turf/open/floor/plasteel/lavaland,
/area/ruins/lavaland/unpowered/generic)
"Mg" = (
/obj/structure/spider/stickyweb,
/obj/structure/spider/cocoon,
/turf/open/floor/plasteel/lavaland,
/area/ruins/lavaland/unpowered/generic)
"Ms" = (
/obj/effect/mob_spawn/human/clown,
/obj/effect/turf_decal/sand,
/obj/effect/spawner/lootdrop/mob/marrow_weaver,
/turf/open/floor/plasteel/lavaland,
/area/ruins/lavaland/unpowered/generic)
"NP" = (
/obj/item/kitchen/knife/combat/bone,
/obj/structure/spider/stickyweb,
/turf/open/floor/plating/asteroid/basalt/lava_land_surface,
/area/ruins/lavaland/unpowered/generic)
"On" = (
/obj/effect/mob_spawn/human/corpse/russian/ranged,
/obj/item/storage/firstaid,
/obj/effect/turf_decal/sand,
/obj/structure/spider/stickyweb,
/turf/open/floor/plasteel/lavaland,
/area/ruins/lavaland/unpowered/generic)
"PG" = (
/obj/item/tank/internals/emergency_oxygen/double,
/obj/structure/spider/stickyweb,
/turf/open/floor/plating/asteroid/basalt/lava_land_surface,
/area/ruins/lavaland/unpowered/generic)
"PI" = (
/obj/effect/turf_decal/sand,
/obj/structure/spider/stickyweb,
/obj/structure/spider/cocoon,
/turf/open/floor/plasteel/lavaland,
/area/ruins/lavaland/unpowered/generic)
"PL" = (
/obj/structure/spider/stickyweb,
/obj/structure/spider/stickyweb,
/obj/structure/spider/cocoon,
/turf/open/floor/plating/asteroid/basalt/lava_land_surface,
/area/ruins/lavaland/unpowered/generic)
"PM" = (
/obj/structure/spider/stickyweb,
/obj/effect/mob_spawn/human/skeleton,
/obj/effect/spawner/lootdrop/mob/marrow_weaver,
/turf/open/floor/plating/asteroid/basalt/lava_land_surface,
/area/ruins/lavaland/unpowered/generic)
"RK" = (
/turf/open/lava/smooth/lava_land_surface,
/area/external/mining/lavaland/explored)
"RN" = (
/obj/effect/turf_decal/sand,
/obj/item/flashlight/flare/torch,
/obj/effect/spawner/lootdrop/mob/marrow_weaver,
/obj/structure/spider/stickyweb,
/turf/open/floor/plasteel/lavaland,
/area/ruins/lavaland/unpowered/generic)
"RW" = (
/obj/item/flashlight/flare/torch,
/turf/open/floor/plating/asteroid/basalt/lava_land_surface,
/area/ruins/lavaland/unpowered/generic)
"Ta" = (
/obj/item/kitchen/knife/combat/bone,
/turf/open/floor/plating/asteroid/basalt/lava_land_surface,
/area/ruins/lavaland/unpowered/generic)
"TB" = (
/obj/effect/mob_spawn/human/corpse/damaged{
	gloves = /obj/item/clothing/gloves/yogs/chitinhands;
	shoes = /obj/item/clothing/shoes/yogs/chitintreads;
	suit = /obj/item/clothing/suit/yogs/armor/chitinplate
	},
/obj/item/pickaxe/drill/diamonddrill,
/obj/effect/turf_decal/sand,
/obj/structure/spider/stickyweb,
/obj/structure/spider/cocoon,
/turf/open/floor/plasteel/lavaland,
/area/ruins/lavaland/unpowered/generic)
"TN" = (
/obj/structure/spider/stickyweb,
/obj/structure/spider/stickyweb,
/obj/effect/mob_spawn/human/skeleton,
/obj/item/reagent_containers/food/snacks/spidereggs,
/turf/open/floor/plating/asteroid/basalt/lava_land_surface,
/area/ruins/lavaland/unpowered/generic)
"UZ" = (
/obj/effect/turf_decal/sand,
/obj/structure/spider/stickyweb,
/obj/structure/spider/stickyweb,
/turf/open/floor/plasteel/lavaland,
/area/ruins/lavaland/unpowered/generic)
"Vc" = (
/obj/item/reagent_containers/food/snacks/spidereggs,
/obj/structure/spider/stickyweb,
/turf/open/floor/plating/asteroid/basalt/lava_land_surface,
/area/ruins/lavaland/unpowered/generic)
"Wa" = (
/obj/effect/spawner/lootdrop/mob/marrow_weaver,
/obj/structure/spider/stickyweb,
/obj/structure/spider/stickyweb,
/turf/open/floor/plating/asteroid/basalt/lava_land_surface,
/area/ruins/lavaland/unpowered/generic)
"YF" = (
/obj/item/flashlight/flare/torch,
/obj/item/reagent_containers/food/snacks/spiderleg,
/turf/open/floor/plating/asteroid/basalt/lava_land_surface,
/area/ruins/lavaland/unpowered/generic)
"YU" = (
/obj/item/tank/internals/air,
/obj/structure/spider/stickyweb,
/turf/open/floor/plating/asteroid/basalt/lava_land_surface,
/area/ruins/lavaland/unpowered/generic)
"Zp" = (
/obj/structure/spider/stickyweb,
/obj/structure/spider/cocoon,
/turf/open/floor/plating/asteroid/basalt/lava_land_surface,
/area/ruins/lavaland/unpowered/generic)

(1,1,1) = {"
HM
HM
HM
HM
HM
HM
HM
HM
HM
HM
HM
HM
HM
HM
RK
HM
RK
HM
HM
HM
HM
HM
HM
HM
HM
HM
HM
HM
HM
HM
HM
HM
HM
HM
HM
"}
(2,1,1) = {"
HM
HM
HM
HM
HM
HM
HM
HM
HM
HM
jy
HM
HM
RK
RK
RK
RK
RK
HM
HM
HM
HM
HM
RK
HM
HM
HM
RK
HM
HM
RK
RK
HM
HM
HM
"}
(3,1,1) = {"
HM
HM
HM
HM
HM
RK
RK
HM
RK
RK
jy
RK
RK
RK
RK
RK
RK
RK
cR
gi
cR
HM
RK
RK
RK
HM
RK
RK
HM
RK
RK
RK
RK
HM
HM
"}
(4,1,1) = {"
HM
HM
HM
RK
RK
RK
RK
RK
RK
RK
RK
RK
RK
wH
jy
jy
RK
cR
cR
gi
cR
cR
RK
RK
RK
RK
RK
RK
RK
RK
wH
RK
RK
RK
HM
"}
(5,1,1) = {"
HM
HM
RK
RK
wH
jy
RK
RK
cR
cR
RK
cR
RK
RK
RK
RK
jy
cR
cR
As
cR
cR
cR
cR
RK
RK
RK
jy
RK
RK
wH
jy
RK
RK
HM
"}
(6,1,1) = {"
HM
HM
HM
RK
RK
RK
cR
cR
cR
cR
cR
cR
cR
cR
RK
cR
cR
cR
cR
xw
xw
cR
cR
cR
cR
cR
RK
jy
cR
RK
RK
RK
RK
HM
HM
"}
(7,1,1) = {"
HM
HM
RK
RK
RK
cR
cR
IP
IP
IP
IP
IP
IP
cR
cR
cR
cR
cR
Hl
bh
gi
Hl
If
cR
cR
cR
cR
cR
cR
cR
RK
RK
wH
HM
HM
"}
(8,1,1) = {"
HM
HM
RK
RK
RK
cR
IP
Ji
hR
IP
Dx
On
IP
zU
zU
Wa
cR
xw
xw
He
zU
zU
bh
xw
cR
cR
cR
IP
IP
cR
cR
RK
RK
HM
HM
"}
(9,1,1) = {"
HM
RK
RK
RK
cR
cR
IP
UZ
UZ
vl
Kj
UZ
zp
IP
zU
RW
bh
bh
zU
zU
zU
zU
zU
lH
cR
IP
dV
qR
IP
cR
cR
RK
RK
HM
HM
"}
(10,1,1) = {"
HM
HM
RK
RK
cR
cR
IP
tT
If
If
If
vl
IP
zU
zU
zU
UZ
zU
zU
zU
zU
bh
xw
Hl
cR
IP
If
If
IP
cR
cR
RK
RK
RK
HM
"}
(11,1,1) = {"
HM
RK
RK
RK
cR
cR
IP
If
Ms
If
fQ
UZ
IP
IP
cK
PM
bh
zU
zU
IP
bh
bh
zU
xw
cR
IP
KW
If
IP
cR
jy
jy
RK
RK
RK
"}
(12,1,1) = {"
HM
RK
RK
RK
RK
cR
IP
sQ
If
If
vl
Kj
qi
IP
wY
bh
bh
UZ
UZ
bh
za
zU
zU
bh
cR
cR
IP
Ai
IP
cR
jy
RK
RK
RK
HM
"}
(13,1,1) = {"
HM
RK
RK
RK
cR
cR
IP
cR
tT
If
cR
TB
IP
zU
zU
zU
bh
If
PI
lH
xw
IP
bh
bh
gi
cR
bd
If
cR
cR
cR
RK
RK
HM
HM
"}
(14,1,1) = {"
HM
RK
RK
RK
cR
cR
cR
IP
cR
xw
IP
IP
zU
zU
zU
xw
As
IP
zU
wY
bh
zU
xw
zU
Kj
lH
xw
xw
PL
IP
cR
RK
RK
RK
HM
"}
(15,1,1) = {"
HM
HM
RK
RK
RK
cR
cR
cR
cR
If
Fj
zU
zU
zU
RW
bh
lH
zU
zU
zU
bh
Fj
If
zU
zU
Em
xw
bh
cR
cR
cR
RK
RK
jy
HM
"}
(16,1,1) = {"
HM
HM
HM
RK
RK
RK
cR
cR
Zp
bh
sQ
zU
IP
PG
xw
If
xw
xw
zU
zU
zU
ic
zU
zU
zU
zU
IP
bh
KT
cR
IP
FZ
jy
jy
jy
"}
(17,1,1) = {"
HM
HM
RK
RK
RK
RK
RK
IP
Fj
bh
PI
zU
zU
xw
Wa
zU
zU
bh
xw
Kj
UZ
NP
IP
zU
zU
zU
lH
gi
Dy
xw
IP
ed
jy
jy
jy
"}
(18,1,1) = {"
HM
RK
RK
RK
jy
RK
cR
cR
cR
gi
zU
zU
tT
bh
zU
zU
zU
xw
Zp
zU
gl
xw
xw
xw
lH
zU
vk
bh
zU
UZ
UZ
jy
jy
jy
jy
"}
(19,1,1) = {"
HM
HM
RK
wH
jy
RK
cR
IH
cR
As
zU
zU
lH
bh
IP
TN
As
xw
zU
zU
cK
hx
zU
wY
bh
Fj
bh
zU
zU
bh
If
jy
jy
jy
HM
"}
(20,1,1) = {"
HM
RK
RK
jy
RK
cR
cR
xw
Wa
If
zU
wY
xw
xw
lH
bh
bh
bh
zU
zU
bh
zU
zU
zU
bh
lH
Zp
zU
As
gi
IP
jy
jy
jy
HM
"}
(21,1,1) = {"
HM
RK
RK
RK
RK
cR
cR
bh
cR
lH
RN
IP
Zp
Fj
zU
zU
YF
gi
zU
zU
Fj
zU
zU
zU
zU
zU
xw
xw
bh
cR
cR
RK
jy
HM
HM
"}
(22,1,1) = {"
HM
RK
HM
RK
RK
cR
cR
xw
cR
gi
zU
zU
zU
bh
bh
zU
zU
xw
vl
IP
bh
wY
zU
IP
zU
zU
zU
Jj
cR
cR
cR
RK
HM
HM
HM
"}
(23,1,1) = {"
HM
RK
HM
HM
RK
RK
cR
IH
cR
If
If
gh
xw
lH
bh
bh
Kj
lH
zU
PL
xw
xw
xw
tT
zU
zU
Fj
lH
cR
cR
RK
RK
RK
HM
HM
"}
(24,1,1) = {"
HM
HM
HM
RK
RK
cR
cR
IP
IP
Wa
zU
zU
zW
IP
JY
xw
xw
zU
zU
zU
zU
xw
bh
bh
xw
bh
bh
cR
cR
RK
RK
RK
HM
HM
HM
"}
(25,1,1) = {"
HM
HM
HM
RK
cR
IP
cR
av
bh
lH
gi
xw
bh
bh
zU
Zp
zU
zU
xw
Fj
bh
If
bh
IP
zU
bh
UZ
xw
cR
cR
RK
RK
RK
RK
HM
"}
(26,1,1) = {"
HM
HM
RK
RK
cR
cR
lt
bh
bh
cf
to
IP
cR
RW
zU
zU
zU
Vc
xw
zU
IP
zU
YU
zU
zU
xw
IP
pq
wY
cR
cR
RK
RK
HM
HM
"}
(27,1,1) = {"
HM
RK
RK
RK
cR
zW
If
If
Fj
bh
Ta
bh
Hl
bh
zU
xw
lH
bh
bh
zU
oF
zU
xw
If
Zp
Wa
cR
DK
IP
cR
cR
RK
HM
HM
HM
"}
(28,1,1) = {"
HM
RK
jy
RK
IP
cR
lH
bh
bh
bh
bh
bh
cR
If
As
gi
cR
IP
xw
bh
xw
xw
xw
RW
cR
cR
cR
cR
cR
cR
RK
RK
RK
HM
HM
"}
(29,1,1) = {"
HM
RK
jy
RK
IP
PI
lH
tT
RW
Dd
Lc
Mg
IP
cR
cR
cR
cR
cR
UZ
wY
zU
gi
IP
cR
cR
cR
cR
cR
cR
RK
RK
jy
RK
RK
HM
"}
(30,1,1) = {"
HM
HM
jy
RK
cR
cR
vl
IP
cR
Vc
IP
cR
cR
cR
cR
RK
cR
jy
jy
IP
zU
xw
RK
cR
cR
cR
RK
RK
RK
RK
wH
jy
RK
HM
HM
"}
(31,1,1) = {"
HM
HM
RK
RK
RK
cR
cR
cR
RK
IP
cR
RK
jy
jy
RK
RK
RK
jy
jy
jy
jy
jy
RK
RK
RK
RK
RK
wH
wH
RK
RK
RK
RK
RK
HM
"}
(32,1,1) = {"
HM
HM
RK
RK
RK
RK
RK
RK
RK
RK
RK
RK
wH
RK
RK
RK
RK
RK
jy
jy
jy
RK
RK
jy
RK
RK
RK
RK
RK
RK
HM
RK
RK
HM
HM
"}
(33,1,1) = {"
HM
HM
RK
RK
RK
RK
RK
wH
RK
RK
RK
RK
RK
RK
HM
RK
RK
HM
jy
jy
jy
RK
RK
RK
RK
HM
HM
RK
RK
HM
HM
HM
RK
HM
HM
"}
(34,1,1) = {"
HM
HM
HM
RK
HM
HM
RK
wH
RK
HM
RK
RK
HM
HM
HM
HM
HM
HM
HM
jy
HM
HM
HM
HM
HM
HM
HM
HM
HM
HM
HM
HM
HM
HM
HM
"}
(35,1,1) = {"
HM
HM
HM
HM
HM
HM
HM
HM
HM
HM
HM
HM
HM
HM
HM
HM
HM
HM
HM
jy
HM
HM
HM
HM
HM
HM
HM
HM
HM
HM
HM
HM
HM
HM
HM
"}
