//MAP CONVERTED BY dmm2tgm.py THIS HEADER COMMENT PREVENTS RECONVERSION, DO NOT REMOVE
"a" = (
/turf/open/floor/plating,
/area/icemoon/underground/explored)
"c" = (
/turf/closed/wall,
/area/icemoon/underground/explored)
"e" = (
/obj/structure/mecha_wreckage/clarke,
/obj/effect/turf_decal/delivery,
/turf/open/floor/plasteel/dark,
/area/icemoon/underground/explored)
"h" = (
/obj/item/stack/rods{
	amount = 2
	},
/turf/open/floor/plating/snowed/smoothed/icemoon,
/area/icemoon/underground/explored)
"k" = (
/obj/structure/mecha_wreckage/clarke,
/obj/effect/turf_decal/delivery,
/obj/effect/turf_decal/delivery,
/turf/open/floor/plasteel/dark,
/area/icemoon/underground/explored)
"p" = (
/obj/structure/girder/displaced,
/turf/open/floor/plating/snowed/smoothed/icemoon,
/area/icemoon/underground/explored)
"q" = (
/obj/effect/turf_decal/delivery,
/turf/open/floor/plasteel/dark,
/area/icemoon/underground/explored)
"s" = (
/turf/open/floor/plasteel/stairs/goon/dark_stairs_wide2{
	dir = 1
	},
/area/icemoon/underground/explored)
"u" = (
/obj/effect/turf_decal/delivery,
/obj/item/mecha_parts/chassis/clarke,
/turf/open/floor/plasteel/dark,
/area/icemoon/underground/explored)
"v" = (
/turf/open/space/basic,
/area/icemoon/underground/explored)
"w" = (
/turf/open/floor/plating/snowed/smoothed/icemoon,
/area/icemoon/underground/explored)
"x" = (
/turf/open/lava/plasma/ice_moon,
/area/icemoon/underground/explored)
"y" = (
/obj/effect/spawner/structure/window/reinforced/shutter,
/turf/open/floor/plating,
/area/icemoon/underground/explored)
"z" = (
/obj/machinery/door/airlock/external/glass,
/obj/machinery/atmospherics/pipe/layer_manifold,
/obj/effect/mapping_helpers/airlock/cyclelink_helper{
	dir = 1
	},
/obj/effect/mapping_helpers/airlock/locked,
/obj/effect/mapping_helpers/airlock/inaccessible,
/turf/open/floor/plating,
/area/icemoon/underground/explored)
"A" = (
/turf/open/floor/plasteel/stairs/goon/dark_stairs_middle{
	dir = 1
	},
/area/icemoon/underground/explored)
"B" = (
/obj/machinery/advanced_airlock_controller/lavaland{
	dir = 4;
	pixel_x = 23
	},
/obj/machinery/atmospherics/components/binary/dp_vent_pump/layer2{
	dir = 1
	},
/obj/machinery/atmospherics/pipe/simple/scrubbers/hidden/layer4,
/turf/open/floor/plating,
/area/icemoon/underground/explored)
"F" = (
/turf/open/floor/plating/asteroid/snow/icemoon,
/area/icemoon/underground/explored)
"J" = (
/obj/machinery/door/airlock/external/glass,
/obj/machinery/atmospherics/pipe/simple/supply/hidden/layer2,
/obj/machinery/atmospherics/pipe/simple/scrubbers/hidden/layer4,
/obj/effect/mapping_helpers/airlock/cyclelink_helper,
/obj/effect/mapping_helpers/airlock/inaccessible,
/turf/open/floor/plating,
/area/icemoon/underground/explored)
"N" = (
/obj/structure/girder,
/turf/open/floor/plating/snowed/smoothed/icemoon,
/area/icemoon/underground/explored)
"Q" = (
/turf/open/floor/plasteel/stairs/goon/dark_stairs_wide{
	dir = 1
	},
/area/icemoon/underground/explored)
"R" = (
/turf/open/floor/plasteel/dark,
/area/icemoon/underground/explored)
"S" = (
/turf/closed/mineral/random/snow,
/area/icemoon/underground/explored)
"V" = (
/obj/structure/lattice,
/turf/open/lava/plasma/ice_moon,
/area/icemoon/underground/explored)
"W" = (
/mob/living/simple_animal/hostile/asteroid/hivelord/legion/snow,
/turf/open/floor/plating/asteroid/snow/icemoon,
/area/icemoon/underground/explored)

(1,1,1) = {"
F
F
F
F
F
F
F
F
F
F
F
F
F
F
F
F
F
F
F
F
F
F
F
F
F
F
F
F
F
F
F
F
F
F
F
F
F
F
F
F
"}
(2,1,1) = {"
F
F
F
F
F
F
F
F
F
S
S
S
S
S
S
S
S
F
F
F
F
F
F
F
F
F
F
F
F
F
F
F
F
F
F
F
F
F
F
F
"}
(3,1,1) = {"
F
F
F
F
F
F
F
F
S
S
S
S
S
S
S
S
S
S
F
F
F
F
F
F
F
F
F
F
F
F
F
F
F
F
F
F
F
F
F
F
"}
(4,1,1) = {"
F
F
F
F
F
F
S
S
S
S
S
S
S
S
S
S
S
S
S
S
F
F
F
F
F
F
F
F
F
F
F
F
F
F
F
F
F
F
F
F
"}
(5,1,1) = {"
F
F
F
F
F
S
S
S
S
S
S
S
S
S
S
S
S
S
S
S
F
F
F
F
x
x
x
F
F
F
F
F
F
F
F
F
F
F
F
F
"}
(6,1,1) = {"
F
F
F
F
F
S
S
S
S
S
S
S
S
S
S
S
S
S
S
S
S
F
F
F
x
x
x
x
F
F
F
F
F
F
F
F
F
F
F
F
"}
(7,1,1) = {"
F
F
F
F
S
S
S
S
S
S
S
F
F
F
S
S
S
S
S
S
S
F
F
F
F
x
x
x
F
F
F
F
F
F
F
F
F
F
F
F
"}
(8,1,1) = {"
F
F
F
S
S
S
S
S
S
S
S
F
S
F
F
S
S
S
S
S
F
F
F
F
F
x
x
x
x
F
F
F
F
F
F
F
F
F
F
F
"}
(9,1,1) = {"
F
F
S
S
S
S
S
S
S
S
S
S
S
S
F
S
S
S
S
S
F
F
F
F
x
x
x
x
x
F
F
F
F
F
F
F
F
F
F
F
"}
(10,1,1) = {"
F
F
S
S
S
x
x
S
S
S
S
S
S
S
F
S
S
S
S
S
F
F
F
x
x
x
x
x
F
F
F
F
F
F
F
F
F
F
F
F
"}
(11,1,1) = {"
F
F
S
S
S
x
x
x
S
S
S
S
S
S
F
S
S
S
S
F
F
F
F
x
x
x
x
x
F
F
F
x
x
x
x
x
F
F
F
F
"}
(12,1,1) = {"
F
F
S
S
S
S
x
x
S
S
S
S
F
F
F
F
F
F
F
F
F
F
x
x
x
x
x
x
F
F
F
x
x
x
x
x
x
F
F
F
"}
(13,1,1) = {"
F
F
S
S
S
x
x
x
S
S
F
F
F
F
F
F
F
F
F
F
x
x
x
x
x
x
x
x
F
F
F
F
F
x
x
x
x
F
F
F
"}
(14,1,1) = {"
F
F
F
S
x
x
x
S
S
F
F
F
F
F
F
F
F
F
F
x
x
x
x
x
x
x
x
x
x
F
F
F
F
x
x
x
x
x
F
F
"}
(15,1,1) = {"
F
F
F
S
S
x
x
S
S
S
F
F
F
F
F
F
F
F
F
V
x
x
x
x
x
x
x
x
x
F
F
F
F
x
x
x
x
x
F
F
"}
(16,1,1) = {"
F
F
F
S
S
S
S
S
S
S
S
S
v
v
v
v
v
v
v
c
V
x
x
x
x
x
F
F
F
F
F
F
F
F
x
x
x
F
F
F
"}
(17,1,1) = {"
F
F
F
S
S
S
S
S
S
c
c
a
a
a
a
a
a
a
a
c
c
V
x
x
x
F
F
F
F
F
F
F
F
F
x
x
x
F
F
F
"}
(18,1,1) = {"
F
F
F
F
S
S
S
S
c
c
a
a
a
a
a
a
a
a
a
a
c
F
F
x
F
F
F
F
F
F
F
F
F
F
x
x
x
x
F
F
"}
(19,1,1) = {"
F
F
F
S
S
S
c
c
c
a
a
a
a
a
a
a
a
a
a
w
c
w
F
F
F
F
F
F
F
F
F
F
F
x
x
x
x
x
x
F
"}
(20,1,1) = {"
F
F
S
S
S
S
c
a
a
a
a
a
a
a
a
a
a
a
w
w
h
w
F
F
F
F
F
F
W
F
F
F
F
F
F
F
x
x
x
F
"}
(21,1,1) = {"
F
F
S
S
S
S
c
a
a
a
a
a
a
a
a
a
a
a
w
w
N
w
F
F
F
F
F
F
F
F
F
F
F
F
F
x
x
x
F
F
"}
(22,1,1) = {"
F
F
S
S
S
S
c
a
R
R
a
a
a
a
a
a
a
a
a
w
p
F
F
w
F
F
F
F
F
F
F
F
F
F
F
x
x
x
F
F
"}
(23,1,1) = {"
F
F
F
S
S
S
c
R
R
R
Q
a
a
a
a
a
a
a
a
w
c
F
F
F
F
F
F
F
F
F
F
F
F
F
F
x
x
x
x
F
"}
(24,1,1) = {"
F
F
S
S
S
S
c
R
k
R
A
a
a
a
a
a
a
a
a
a
c
F
F
F
F
F
F
F
F
F
F
F
F
F
F
F
x
x
x
F
"}
(25,1,1) = {"
F
S
S
S
S
S
c
R
q
R
A
a
a
a
a
a
a
a
a
a
c
F
F
F
F
F
F
F
F
F
F
F
F
F
F
F
x
x
x
F
"}
(26,1,1) = {"
F
S
S
S
S
S
c
R
e
R
A
a
a
a
a
a
a
a
a
a
y
F
F
F
F
F
F
F
F
S
F
F
F
F
F
F
x
x
x
F
"}
(27,1,1) = {"
F
S
S
S
S
S
c
R
u
R
s
a
a
a
a
a
a
a
a
a
y
y
y
F
F
F
F
F
S
S
S
F
F
F
F
x
x
x
x
F
"}
(28,1,1) = {"
F
F
S
S
S
S
c
a
a
a
a
a
a
a
a
a
a
a
a
a
J
B
z
F
F
F
F
F
S
S
S
S
F
F
F
x
x
x
x
F
"}
(29,1,1) = {"
F
F
S
S
S
S
c
a
a
a
a
a
a
a
a
a
a
a
a
c
c
c
y
F
F
F
F
S
S
S
S
S
F
F
F
x
x
x
x
F
"}
(30,1,1) = {"
F
F
S
S
S
S
c
c
a
a
a
a
a
a
a
a
a
a
a
c
S
F
F
F
F
F
S
S
S
S
S
S
F
F
F
F
x
x
x
F
"}
(31,1,1) = {"
F
F
S
S
S
S
S
c
c
a
a
a
a
a
a
a
a
a
c
c
S
F
F
F
F
S
S
S
S
S
S
S
F
F
F
F
x
x
x
F
"}
(32,1,1) = {"
F
F
S
S
S
S
S
S
c
c
a
a
a
a
a
a
a
c
c
S
S
S
S
F
F
S
S
S
S
S
S
S
F
F
F
x
x
x
F
F
"}
(33,1,1) = {"
F
F
F
S
S
S
S
S
S
c
c
c
c
c
c
c
c
c
S
S
S
S
S
S
S
S
S
S
S
S
S
S
F
F
F
x
x
x
F
F
"}
(34,1,1) = {"
F
F
F
F
S
S
S
S
S
S
S
S
S
S
S
S
S
S
S
S
S
S
S
S
S
S
S
S
S
S
S
F
F
F
F
F
x
x
x
F
"}
(35,1,1) = {"
F
F
F
S
S
S
S
S
S
S
S
S
S
S
S
S
S
S
S
S
S
S
S
S
S
S
S
S
S
S
F
F
F
F
F
F
F
x
F
F
"}
(36,1,1) = {"
F
F
F
S
S
S
S
S
S
S
S
S
S
S
S
S
S
S
S
S
S
S
S
S
S
S
S
S
S
S
F
F
F
F
F
F
F
F
F
F
"}
(37,1,1) = {"
F
F
F
F
S
S
S
S
S
S
F
S
S
S
S
S
S
S
S
S
S
S
S
S
S
S
S
S
S
F
F
F
F
F
F
F
F
F
F
F
"}
(38,1,1) = {"
F
F
F
F
F
F
F
S
S
S
F
F
S
S
S
S
S
F
F
F
S
S
S
S
S
S
S
S
S
F
F
F
F
F
F
F
F
F
F
F
"}
(39,1,1) = {"
F
F
F
F
F
F
F
F
F
F
F
F
S
S
S
F
F
F
F
F
F
F
S
S
S
S
S
F
F
F
F
F
F
F
F
F
F
F
F
F
"}
(40,1,1) = {"
F
F
F
F
F
F
F
F
F
F
F
F
F
F
F
F
F
F
F
F
F
F
F
F
F
F
F
F
F
F
F
F
F
F
F
F
F
F
F
F
"}
