//MAP CONVERTED BY dmm2tgm.py THIS HEADER COMMENT PREVENTS RECONVERSION, DO NOT REMOVE
"aa" = (
/obj/machinery/light/small{
	dir = 4
	},
/turf/open/floor/wood,
/area/ruins/icemoon/powered/hermit)
"ab" = (
/obj/structure/rack,
/obj/machinery/light/small{
	dir = 1
	},
/obj/item/grown/log/tree,
/obj/item/grown/log/tree,
/obj/item/grown/log/tree,
/obj/item/grown/log/tree,
/obj/item/grown/log/tree,
/turf/open/floor/plating/snowed/smoothed/icemoon,
/area/ruins/icemoon/powered/hermit)
"ac" = (
/obj/structure/flora/tree/pine,
/turf/open/floor/plating/asteroid/snow/icemoon,
/area/external/mining/icemoon/surface/explored)
"ad" = (
/obj/effect/decal/cleanable/dirt,
/turf/open/floor/plasteel/cafeteria,
/area/ruins/icemoon/powered/hermit)
"ae" = (
/turf/open/floor/plasteel/cafeteria,
/area/ruins/icemoon/powered/hermit)
"af" = (
/obj/machinery/smartfridge/food,
/turf/open/floor/wood,
/area/ruins/icemoon/powered/hermit)
"ah" = (
/obj/structure/fans/tiny,
/obj/machinery/door/airlock/wood,
/turf/open/floor/wood,
/area/ruins/icemoon/powered/hermit)
"ai" = (
/obj/machinery/griddle,
/obj/effect/decal/cleanable/dirt,
/turf/open/floor/plasteel/cafeteria,
/area/ruins/icemoon/powered/hermit)
"ak" = (
/obj/effect/decal/cleanable/dirt,
/turf/open/floor/carpet,
/area/ruins/icemoon/powered/hermit)
"am" = (
/turf/open/floor/wood,
/area/ruins/icemoon/powered/hermit)
"ao" = (
/obj/effect/decal/cleanable/dirt,
/obj/machinery/light/small{
	dir = 8
	},
/turf/open/floor/wood,
/area/ruins/icemoon/powered/hermit)
"ap" = (
/obj/structure/flora/tree/dead,
/turf/open/floor/plating/asteroid/snow/icemoon,
/area/external/mining/icemoon/surface/explored)
"aq" = (
/obj/item/bedsheet,
/obj/structure/bed,
/obj/effect/mob_spawn/human/icemoon_hermit{
	dir = 8
	},
/turf/open/floor/wood,
/area/ruins/icemoon/powered/hermit)
"at" = (
/turf/open/floor/carpet,
/area/ruins/icemoon/powered/hermit)
"av" = (
/obj/machinery/light/small,
/turf/open/floor/wood,
/area/ruins/icemoon/powered/hermit)
"aw" = (
/obj/effect/decal/cleanable/dirt,
/obj/structure/mirror{
	pixel_y = 56
	},
/turf/open/floor/wood,
/area/ruins/icemoon/powered/hermit)
"ax" = (
/obj/structure/barricade/wooden/crude/snow,
/obj/structure/window/reinforced/fulltile/ice,
/turf/open/floor/plating/snowed/smoothed/icemoon,
/area/ruins/icemoon/powered/hermit)
"ay" = (
/obj/machinery/light/small{
	dir = 4
	},
/obj/structure/sink/kitchen{
	pixel_y = 30
	},
/turf/open/floor/plasteel/cafeteria,
/area/ruins/icemoon/powered/hermit)
"aA" = (
/obj/structure/fireplace{
	fuel_added = 1000;
	lit = 1
	},
/obj/effect/decal/cleanable/dirt,
/turf/open/floor/carpet,
/area/ruins/icemoon/powered/hermit)
"aC" = (
/obj/structure/rack,
/obj/item/grown/log/tree,
/obj/item/grown/log/tree,
/obj/item/grown/log/tree,
/obj/item/grown/log/tree,
/obj/item/grown/log/tree,
/turf/open/floor/plating/snowed/smoothed/icemoon,
/area/ruins/icemoon/powered/hermit)
"aD" = (
/obj/structure/dresser,
/turf/open/floor/wood{
	icon_state = "wood-broken6"
	},
/area/ruins/icemoon/powered/hermit)
"aE" = (
/obj/machinery/vending/clothing{
	onstation = 0
	},
/turf/open/floor/wood,
/area/ruins/icemoon/powered/hermit)
"aF" = (
/obj/structure/table/wood,
/obj/item/kitchen/rollingpin,
/turf/open/floor/plasteel/cafeteria,
/area/ruins/icemoon/powered/hermit)
"aG" = (
/obj/machinery/processor,
/turf/open/floor/wood,
/area/ruins/icemoon/powered/hermit)
"aI" = (
/turf/closed/wall/mineral/wood,
/area/ruins/icemoon/powered/hermit)
"aK" = (
/obj/structure/curtain,
/turf/open/floor/wood,
/area/ruins/icemoon/powered/hermit)
"aL" = (
/turf/template_noop,
/area/template_noop)
"aM" = (
/obj/structure/mineral_door/wood,
/turf/open/floor/plating/snowed/smoothed/icemoon,
/area/ruins/icemoon/powered/hermit)
"aO" = (
/obj/machinery/vending/hydroseeds{
	onstation = 0
	},
/turf/open/floor/plating/snowed/smoothed/icemoon,
/area/ruins/icemoon/powered/hermit)
"aP" = (
/turf/open/floor/plating/snowed/smoothed/icemoon,
/area/external/mining/icemoon/surface/explored)
"aQ" = (
/obj/effect/decal/cleanable/dirt,
/obj/structure/table/wood,
/obj/machinery/reagentgrinder/kitchen,
/turf/open/floor/wood,
/area/ruins/icemoon/powered/hermit)
"aR" = (
/obj/machinery/chem_dispenser/mutagensaltpeter,
/turf/open/floor/plating/snowed/smoothed/icemoon,
/area/ruins/icemoon/powered/hermit)
"aS" = (
/obj/effect/decal/cleanable/dirt,
/obj/structure/closet/secure_closet/freezer/kitchen/maintenance{
	name = "refrigerator"
	},
/turf/open/floor/plasteel/cafeteria,
/area/ruins/icemoon/powered/hermit)
"aT" = (
/turf/open/floor/plating/asteroid/snow/icemoon,
/area/external/mining/icemoon/surface/explored)
"aU" = (
/obj/machinery/light/small{
	dir = 8
	},
/turf/open/floor/wood,
/area/ruins/icemoon/powered/hermit)
"aV" = (
/obj/machinery/biogenerator,
/turf/open/floor/plating/snowed/smoothed/icemoon,
/area/ruins/icemoon/powered/hermit)
"aW" = (
/obj/structure/table/wood,
/obj/item/kitchen/knife/combat/bone,
/turf/open/floor/plasteel/cafeteria,
/area/ruins/icemoon/powered/hermit)
"aX" = (
/obj/machinery/oven,
/obj/effect/decal/cleanable/dirt,
/turf/open/floor/plasteel/cafeteria,
/area/ruins/icemoon/powered/hermit)
"aY" = (
/turf/open/floor/wood{
	icon_state = "wood-broken"
	},
/area/ruins/icemoon/powered/hermit)
"ey" = (
/obj/structure/window/reinforced{
	dir = 1
	},
/turf/open/floor/plating/snowed/smoothed/icemoon,
/area/ruins/icemoon/powered/hermit)
"eQ" = (
/obj/effect/decal/cleanable/dirt,
/obj/structure/rack,
/obj/item/kinetic_crusher,
/obj/item/gun/energy/kinetic_accelerator,
/obj/item/tank/internals/oxygen,
/obj/item/storage/firstaid/medical,
/turf/open/floor/wood,
/area/ruins/icemoon/powered/hermit)
"fA" = (
/obj/machinery/hydroponics/soil,
/obj/structure/window/reinforced{
	dir = 1
	},
/turf/open/floor/plating/snowed/smoothed/icemoon,
/area/ruins/icemoon/powered/hermit)
"hW" = (
/obj/machinery/hydroponics/soil,
/obj/item/storage/bag/plants/portaseeder,
/turf/open/floor/plating/snowed/smoothed/icemoon,
/area/ruins/icemoon/powered/hermit)
"mH" = (
/obj/machinery/door/airlock/wood,
/obj/structure/fans/tiny,
/turf/open/floor/plating/snowed/smoothed/icemoon,
/area/ruins/icemoon/powered/hermit)
"um" = (
/obj/machinery/hydroponics/soil,
/turf/open/floor/plating/snowed/smoothed/icemoon,
/area/ruins/icemoon/powered/hermit)
"uP" = (
/turf/open/floor/plating/snowed/smoothed/icemoon,
/area/ruins/icemoon/powered/hermit)
"wi" = (
/obj/machinery/hydroponics/soil,
/obj/structure/window/reinforced{
	dir = 8
	},
/turf/open/floor/plating/snowed/smoothed/icemoon,
/area/ruins/icemoon/powered/hermit)
"Fx" = (
/obj/structure/window/reinforced{
	dir = 1
	},
/obj/structure/window/reinforced{
	dir = 8
	},
/turf/open/floor/plating/snowed/smoothed/icemoon,
/area/ruins/icemoon/powered/hermit)
"Mi" = (
/obj/machinery/light/small{
	dir = 1
	},
/obj/machinery/vending/hydronutrients{
	onstation = 0
	},
/turf/open/floor/plating/snowed/smoothed/icemoon,
/area/ruins/icemoon/powered/hermit)
"Ot" = (
/obj/structure/table/wood,
/obj/machinery/light/small{
	dir = 1
	},
/obj/item/reagent_containers/glass/rag{
	pixel_x = 5;
	pixel_y = 4
	},
/turf/open/floor/plasteel/cafeteria,
/area/ruins/icemoon/powered/hermit)
"QO" = (
/obj/effect/decal/cleanable/dirt,
/turf/open/floor/wood,
/area/ruins/icemoon/powered/hermit)
"SZ" = (
/obj/structure/closet/crate/wooden,
/obj/item/reagent_containers/glass/woodmug,
/obj/item/reagent_containers/glass/woodmug,
/obj/item/reagent_containers/glass/woodmug,
/turf/open/floor/plating/snowed/smoothed/icemoon,
/area/ruins/icemoon/powered/hermit)
"Tp" = (
/obj/machinery/door/airlock/wood,
/turf/open/floor/wood,
/area/ruins/icemoon/powered/hermit)

(1,1,1) = {"
aL
aL
aL
aL
aL
aL
aL
aL
aL
aL
aL
aL
aL
aL
aL
aL
aL
aL
"}
(2,1,1) = {"
aL
aL
aT
aT
aT
aT
aT
aT
ac
aT
aT
aT
aT
aT
aT
aT
aL
aL
"}
(3,1,1) = {"
aL
aT
aT
aT
aT
aT
aT
aT
aT
aT
aT
aT
aT
aT
aT
ac
aT
aL
"}
(4,1,1) = {"
aL
aT
Fx
wi
wi
aI
aM
aI
aI
aI
aI
aI
aI
aT
aT
aT
aT
aL
"}
(5,1,1) = {"
aL
aT
ey
uP
uP
aI
uP
uP
aI
aE
aU
am
aI
aT
aT
aT
aT
aL
"}
(6,1,1) = {"
aL
aT
fA
uP
um
aI
ab
aC
aI
aD
aw
aq
aI
aT
aT
aT
aT
aL
"}
(7,1,1) = {"
aL
aT
fA
uP
hW
aI
aI
aI
aI
aI
aK
aI
aI
aT
aT
aT
aT
aL
"}
(8,1,1) = {"
aL
aT
fA
uP
um
aI
at
ak
ao
am
aY
aU
aI
aT
aT
aT
aT
aL
"}
(9,1,1) = {"
aL
aI
aI
mH
aI
aI
aA
ak
am
am
am
am
aI
aP
aP
aT
aT
aL
"}
(10,1,1) = {"
aL
aI
aO
uP
uP
aI
at
ak
aY
am
QO
am
ah
aP
aT
aT
aT
aL
"}
(11,1,1) = {"
aL
aI
Mi
uP
uP
Tp
am
am
am
am
QO
eQ
aI
aP
aP
aP
aT
aL
"}
(12,1,1) = {"
aL
aI
aV
uP
uP
aI
Ot
aF
aW
am
av
aI
aI
aP
aP
aT
aT
aL
"}
(13,1,1) = {"
aL
aI
aR
uP
SZ
aI
ai
ae
ad
am
QO
aI
aT
aP
aT
aT
aT
aL
"}
(14,1,1) = {"
aL
aI
aI
aI
aI
aI
aX
ad
ae
am
aG
aI
aT
aT
aT
aT
aT
aL
"}
(15,1,1) = {"
aL
aT
aT
aT
aT
aI
aS
ae
ae
QO
aQ
aI
aT
aT
aT
ap
aT
aL
"}
(16,1,1) = {"
aL
aT
aT
aT
aT
aI
ay
ae
ae
aa
af
aI
aT
aT
ac
aT
aT
aL
"}
(17,1,1) = {"
aL
aT
aT
ac
aT
aI
aI
ax
ax
aI
aI
aI
aT
aT
aT
aT
aT
aL
"}
(18,1,1) = {"
aL
aL
aT
aT
aT
aT
aT
aT
aT
ap
aT
aT
aT
aT
aT
aT
aL
aL
"}
(19,1,1) = {"
aL
aL
aL
aL
aL
aL
aL
aL
aL
aL
aL
aL
aL
aL
aL
aL
aL
aL
"}
