//MAP CONVERTED BY dmm2tgm.py THIS HEADER COMMENT PREVENTS RECONVERSION, DO NOT REMOVE
"an" = (
/obj/machinery/mass_driver{
	dir = 1;
	id = "chapelgun";
	name = "Holy Driver"
	},
/obj/item/reagent_containers/food/snacks/grown/poppy,
/turf/open/floor/plating,
/area/station/service/chapel/office)
"as" = (
/obj/effect/turf_decal/siding/wideplating{
	dir = 1
	},
/obj/effect/turf_decal/ramp_middle,
/turf/open/floor/carpet/black,
/area/station/service/chapel)
"aH" = (
/obj/effect/turf_decal/siding/wideplating{
	dir = 1
	},
/obj/structure/cable{
	icon_state = "1-2"
	},
/obj/structure/disposalpipe/segment,
/obj/effect/turf_decal/ramp_middle,
/turf/open/floor/carpet/black,
/area/station/service/chapel)
"aW" = (
/obj/machinery/atmospherics/components/unary/vent_pump/on/layer2{
	dir = 4
	},
/turf/open/floor/plasteel/dark,
/area/station/service/chapel)
"bt" = (
/obj/structure/table/wood/fancy/black,
/obj/item/flashlight/lantern,
/turf/open/floor/carpet/black,
/area/station/service/chapel)
"by" = (
/obj/structure/cable{
	icon_state = "1-2"
	},
/obj/structure/disposalpipe/segment,
/turf/open/floor/carpet/black,
/area/station/service/chapel)
"bA" = (
/obj/structure/railing{
	dir = 8
	},
/obj/structure/table/wood/fancy,
/obj/item/flashlight/lantern,
/turf/open/floor/carpet/red,
/area/station/service/chapel)
"cB" = (
/obj/machinery/camera{
	c_tag = "Chapel Office"
	},
/obj/structure/chair,
/obj/machinery/requests_console{
	department = "Chapel";
	departmentType = 2;
	pixel_y = 30
	},
/turf/open/floor/carpet/red,
/area/station/service/chapel/office)
"cC" = (
/obj/machinery/firealarm{
	dir = 8;
	pixel_x = 26
	},
/obj/machinery/vending/wardrobe/chap_wardrobe,
/turf/open/floor/carpet/red,
/area/station/service/chapel/office)
"dd" = (
/obj/machinery/door/airlock/public/glass{
	name = "Chapel"
	},
/obj/machinery/door/firedoor/border_only{
	dir = 4
	},
/obj/machinery/door/firedoor/border_only{
	dir = 8
	},
/obj/structure/cable{
	icon_state = "4-8"
	},
/obj/machinery/atmospherics/pipe/simple/supply/hidden/layer2{
	dir = 4
	},
/obj/machinery/atmospherics/pipe/simple/scrubbers/hidden/layer4{
	dir = 4
	},
/obj/structure/disposalpipe/segment{
	dir = 4
	},
/turf/open/floor/plasteel/dark,
/area/station/service/chapel)
"ds" = (
/obj/structure/railing{
	dir = 8
	},
/turf/open/floor/carpet/red,
/area/station/service/chapel)
"dC" = (
/obj/machinery/atmospherics/components/unary/vent_pump/on/layer2{
	dir = 4
	},
/turf/open/floor/plasteel/chapel,
/area/station/service/chapel)
"dR" = (
/obj/effect/spawner/structure/window,
/turf/open/floor/plating,
/area/station/service/chapel)
"fD" = (
/obj/structure/railing/corner{
	dir = 1
	},
/turf/open/floor/carpet/black,
/area/station/service/chapel)
"gc" = (
/obj/structure/cable{
	icon_state = "1-4"
	},
/obj/structure/cable{
	icon_state = "1-2"
	},
/obj/machinery/atmospherics/pipe/simple/supply/hidden/layer2,
/obj/machinery/atmospherics/pipe/simple/scrubbers/hidden/layer4{
	dir = 1
	},
/obj/structure/disposalpipe/sorting/mail{
	sortType = 17
	},
/obj/effect/mapping_helpers/mail_sorting/service/chapel,
/turf/open/floor/carpet/black,
/area/station/service/chapel/office)
"gr" = (
/obj/structure/cable{
	icon_state = "4-8"
	},
/turf/open/floor/carpet/black,
/area/station/service/chapel/office)
"gB" = (
/obj/structure/railing{
	dir = 8
	},
/turf/open/floor/plasteel/stairs/goon/dark_stairs_wide{
	dir = 1
	},
/area/station/service/chapel)
"gJ" = (
/obj/machinery/door/airlock/maintenance{
	name = "Chapel Maintenance"
	},
/obj/machinery/door/firedoor/border_only{
	dir = 1
	},
/obj/machinery/door/firedoor/border_only,
/obj/structure/cable{
	icon_state = "1-2"
	},
/obj/machinery/atmospherics/pipe/simple/supply/hidden/layer2,
/obj/machinery/atmospherics/pipe/simple/scrubbers/hidden/layer4,
/obj/effect/mapping_helpers/airlock/access/all/engineering/maintenance,
/turf/open/floor/plating,
/area/template_noop)
"gL" = (
/obj/machinery/atmospherics/pipe/simple/supply/hidden/layer2{
	dir = 5
	},
/turf/open/floor/plasteel/dark,
/area/station/service/chapel)
"hp" = (
/obj/effect/turf_decal/siding/wideplating{
	dir = 1
	},
/obj/effect/turf_decal/ramp_middle,
/turf/open/floor/plasteel/chapel{
	dir = 1
	},
/area/station/service/chapel)
"im" = (
/obj/item/pen,
/obj/item/reagent_containers/food/drinks/bottle/holywater,
/obj/structure/table/wood/fancy,
/turf/open/floor/carpet/red,
/area/station/service/chapel/office)
"iB" = (
/obj/machinery/airalarm{
	dir = 4;
	pixel_x = -24
	},
/turf/open/floor/plasteel/dark,
/area/station/service/chapel)
"iO" = (
/turf/open/floor/plasteel/stairs/goon/dark_stairs_wide2{
	dir = 4
	},
/area/station/service/chapel)
"iR" = (
/obj/machinery/atmospherics/components/unary/vent_pump/on/layer2,
/turf/open/floor/plasteel/dark,
/area/station/service/chapel)
"iZ" = (
/obj/effect/turf_decal/ramp_middle{
	dir = 4
	},
/turf/open/floor/plasteel/chapel,
/area/station/service/chapel)
"jb" = (
/obj/structure/chair{
	dir = 1
	},
/obj/structure/cable{
	icon_state = "4-8"
	},
/turf/open/floor/carpet/black,
/area/station/service/chapel/office)
"jk" = (
/obj/effect/spawner/structure/window/reinforced/tinted,
/turf/open/floor/plasteel/dark,
/area/station/service/chapel)
"kI" = (
/turf/template_noop,
/area/template_noop)
"kK" = (
/obj/machinery/door/window{
	dir = 8;
	name = "Mass Driver"
	},
/obj/effect/turf_decal/stripes/line{
	dir = 8
	},
/obj/structure/sign/warning/vacuum/external{
	pixel_y = 32
	},
/obj/effect/mapping_helpers/windoor/access/all/service/chapel_office{
	dir = 8
	},
/turf/open/floor/plasteel/dark,
/area/station/service/chapel/office)
"kU" = (
/obj/effect/turf_decal/ramp_middle,
/obj/machinery/camera{
	c_tag = "Chapel East";
	dir = 8
	},
/turf/open/floor/plasteel/dark,
/area/station/service/chapel)
"ln" = (
/obj/machinery/door/firedoor/border_only{
	dir = 4
	},
/obj/machinery/door/firedoor/border_only{
	dir = 8
	},
/obj/structure/disposalpipe/segment{
	dir = 4
	},
/obj/structure/cable{
	icon_state = "4-8"
	},
/obj/machinery/atmospherics/pipe/simple/supply/hidden/layer2{
	dir = 4
	},
/obj/machinery/atmospherics/pipe/simple/scrubbers/hidden/layer4{
	dir = 4
	},
/obj/machinery/door/airlock/maintenance{
	name = "Crematorium Maintenance"
	},
/obj/effect/mapping_helpers/airlock/access/all/service/crematorium,
/turf/open/floor/plating,
/area/template_noop)
"mq" = (
/obj/structure/chair/wood/normal,
/turf/open/floor/carpet/red,
/area/station/service/chapel)
"oG" = (
/obj/structure/table/wood/fancy,
/obj/structure/railing{
	dir = 6
	},
/turf/open/floor/carpet/red,
/area/station/service/chapel)
"oK" = (
/obj/effect/spawner/structure/window/reinforced,
/turf/open/floor/plating,
/area/station/service/chapel/office)
"oS" = (
/obj/structure/bodycontainer/morgue{
	dir = 8
	},
/turf/open/floor/plasteel/dark,
/area/station/service/chapel/office)
"pf" = (
/obj/machinery/door/morgue{
	name = "Confession Booth"
	},
/obj/machinery/door/firedoor/border_only,
/obj/machinery/door/firedoor/border_only{
	dir = 1
	},
/turf/open/floor/plasteel/dark,
/area/station/service/chapel)
"qy" = (
/obj/effect/turf_decal/ramp_middle{
	dir = 8
	},
/obj/effect/turf_decal/ramp_middle,
/turf/open/floor/plasteel/chapel{
	dir = 1
	},
/area/station/service/chapel)
"qK" = (
/turf/open/floor/plasteel/chapel{
	dir = 4
	},
/area/station/service/chapel)
"qZ" = (
/obj/effect/turf_decal/ramp_middle{
	dir = 8
	},
/turf/open/floor/plasteel/chapel{
	dir = 8
	},
/area/station/service/chapel)
"rx" = (
/obj/structure/table/wood/fancy/black,
/obj/machinery/camera{
	c_tag = "Chapel Central"
	},
/turf/open/floor/carpet/black,
/area/station/service/chapel)
"rG" = (
/obj/effect/turf_decal/ramp_middle{
	dir = 8
	},
/obj/machinery/atmospherics/components/unary/vent_scrubber/on/layer4{
	dir = 8
	},
/turf/open/floor/plasteel/dark,
/area/station/service/chapel)
"sy" = (
/turf/open/floor/plasteel/dark,
/area/station/service/chapel)
"sK" = (
/obj/machinery/atmospherics/pipe/simple/scrubbers/hidden/layer4{
	dir = 4
	},
/turf/open/floor/carpet/black,
/area/station/service/chapel)
"to" = (
/obj/machinery/atmospherics/components/unary/vent_pump/on/layer2,
/obj/machinery/light/small{
	dir = 1
	},
/turf/open/floor/plasteel/dark,
/area/station/service/chapel/office)
"tP" = (
/obj/machinery/atmospherics/components/unary/vent_scrubber/on/layer4,
/turf/open/floor/plasteel/dark,
/area/station/service/chapel)
"vK" = (
/obj/structure/table/wood/fancy,
/obj/structure/railing{
	dir = 10
	},
/turf/open/floor/carpet/red,
/area/station/service/chapel)
"wA" = (
/turf/closed/wall,
/area/template_noop)
"wD" = (
/obj/structure/table/wood/fancy,
/obj/item/reagent_containers/food/snacks/grown/poppy,
/turf/open/floor/plasteel/dark,
/area/station/service/chapel)
"xr" = (
/obj/machinery/airalarm{
	pixel_y = 24
	},
/turf/open/floor/carpet/red,
/area/station/service/chapel/office)
"xL" = (
/turf/closed/wall,
/area/station/service/chapel)
"ym" = (
/obj/effect/turf_decal/ramp_middle{
	dir = 8
	},
/turf/open/floor/plasteel/dark,
/area/station/service/chapel)
"yO" = (
/obj/effect/turf_decal/ramp_middle{
	dir = 4
	},
/turf/open/floor/plasteel/stairs/goon/dark_stairs_middle{
	dir = 1
	},
/area/station/service/chapel)
"za" = (
/obj/machinery/atmospherics/pipe/simple/supply/hidden/layer2{
	dir = 8
	},
/turf/open/floor/plasteel/chapel{
	dir = 1
	},
/area/station/service/chapel)
"zf" = (
/obj/effect/turf_decal/ramp_middle{
	dir = 4
	},
/obj/effect/turf_decal/ramp_middle,
/turf/open/floor/plasteel/chapel{
	dir = 4
	},
/area/station/service/chapel)
"zg" = (
/turf/closed/wall,
/area/station/service/chapel/office)
"zA" = (
/obj/structure/chair{
	dir = 4
	},
/obj/item/radio/intercom{
	broadcasting = 1;
	frequency = 1480;
	name = "Confessional Intercom";
	pixel_y = -30
	},
/obj/machinery/light/small{
	dir = 8
	},
/turf/open/floor/carpet/black,
/area/station/service/chapel)
"zX" = (
/obj/effect/turf_decal/ramp_corner{
	dir = 4
	},
/turf/open/floor/plasteel/chapel{
	dir = 1
	},
/area/station/service/chapel)
"Cq" = (
/obj/item/kirbyplants/random,
/turf/open/floor/plasteel/dark,
/area/station/service/chapel)
"Cv" = (
/obj/machinery/light/small{
	dir = 1
	},
/obj/machinery/atmospherics/components/unary/vent_scrubber/on/layer4{
	dir = 8
	},
/obj/machinery/light_switch{
	pixel_y = 28
	},
/turf/open/floor/carpet/red,
/area/station/service/chapel/office)
"Cz" = (
/obj/structure/cable{
	icon_state = "1-2"
	},
/obj/structure/disposalpipe/segment,
/turf/open/floor/carpet/red,
/area/station/service/chapel)
"CG" = (
/obj/effect/turf_decal/ramp_middle,
/turf/open/floor/plasteel/dark,
/area/station/service/chapel)
"Df" = (
/obj/machinery/light{
	dir = 4
	},
/turf/open/floor/plasteel/dark,
/area/station/service/chapel)
"Dj" = (
/obj/machinery/door/morgue{
	name = "Confession Booth (Chaplain)";
	req_access = list("chapel_office")
	},
/obj/machinery/door/firedoor/border_only,
/obj/machinery/door/firedoor/border_only{
	dir = 1
	},
/turf/open/floor/plasteel/dark,
/area/station/service/chapel)
"Dq" = (
/obj/structure/chair{
	dir = 8
	},
/obj/item/radio/intercom{
	broadcasting = 1;
	frequency = 1480;
	name = "Confessional Intercom";
	pixel_y = -30
	},
/turf/open/floor/carpet/red,
/area/station/service/chapel)
"DL" = (
/obj/structure/table/wood/fancy,
/obj/item/reagent_containers/food/snacks/grown/harebell,
/turf/open/floor/plasteel/dark,
/area/station/service/chapel)
"DV" = (
/obj/machinery/light{
	dir = 8
	},
/turf/open/floor/plasteel/dark,
/area/station/service/chapel)
"DX" = (
/obj/effect/landmark/event_spawn,
/obj/effect/turf_decal/stripes/line{
	dir = 4
	},
/turf/open/floor/plating,
/area/station/service/chapel/office)
"ED" = (
/obj/structure/cable{
	icon_state = "1-2"
	},
/obj/machinery/atmospherics/pipe/simple/supply/hidden/layer2{
	dir = 9
	},
/obj/machinery/atmospherics/pipe/simple/scrubbers/hidden/layer4{
	dir = 5
	},
/obj/structure/disposalpipe/segment,
/turf/open/floor/carpet/black,
/area/station/service/chapel)
"EO" = (
/obj/structure/railing/corner,
/turf/open/floor/carpet/black,
/area/station/service/chapel)
"ER" = (
/obj/machinery/atmospherics/pipe/simple/supply/hidden/layer2,
/obj/machinery/atmospherics/pipe/simple/scrubbers/hidden/layer4{
	dir = 5
	},
/turf/open/floor/plasteel/dark,
/area/station/service/chapel)
"EV" = (
/turf/open/floor/plasteel/chapel,
/area/station/service/chapel)
"EZ" = (
/obj/effect/turf_decal/ramp_corner{
	dir = 8
	},
/turf/open/floor/plasteel/chapel{
	dir = 4
	},
/area/station/service/chapel)
"Fz" = (
/obj/machinery/computer/pod/old{
	density = 0;
	dir = 1;
	icon = 'icons/obj/airlock_machines.dmi';
	icon_state = "airlock_control_standby";
	id = "chapelgun";
	name = "Mass Driver Controller";
	pixel_y = 30;
	req_access = list("chapel_office")
	},
/turf/open/floor/plasteel/dark,
/area/station/service/chapel/office)
"FB" = (
/turf/open/floor/plasteel/stairs/goon/dark_stairs_middle{
	dir = 4
	},
/area/station/service/chapel)
"FD" = (
/turf/open/floor/carpet/black,
/area/station/service/chapel)
"FN" = (
/obj/machinery/door/poddoor{
	id = "chapelgun";
	name = "Chapel Launcher Door"
	},
/obj/structure/fans/tiny,
/turf/open/floor/plating,
/area/station/service/chapel/office)
"Gn" = (
/obj/item/nullrod,
/obj/structure/table/wood/fancy,
/turf/open/floor/carpet/red,
/area/station/service/chapel/office)
"Gs" = (
/obj/structure/cable{
	icon_state = "1-2"
	},
/obj/machinery/atmospherics/pipe/simple/supply/hidden/layer2,
/obj/machinery/atmospherics/pipe/simple/scrubbers/hidden/layer4{
	dir = 1
	},
/obj/structure/disposalpipe/segment,
/turf/open/floor/carpet/black,
/area/station/service/chapel)
"GD" = (
/obj/structure/cable{
	icon_state = "1-2"
	},
/obj/machinery/atmospherics/pipe/simple/supply/hidden/layer2,
/obj/machinery/atmospherics/pipe/simple/scrubbers/hidden/layer4{
	dir = 1
	},
/obj/structure/disposalpipe/segment,
/turf/open/floor/carpet/red,
/area/station/service/chapel/office)
"He" = (
/obj/machinery/light{
	dir = 1
	},
/turf/open/floor/plasteel/chapel{
	dir = 1
	},
/area/station/service/chapel)
"Hp" = (
/obj/effect/turf_decal/ramp_middle{
	dir = 8
	},
/turf/open/floor/plasteel/stairs/goon/dark_stairs_middle{
	dir = 1
	},
/area/station/service/chapel)
"Ia" = (
/obj/structure/table/wood/fancy/black,
/obj/machinery/light{
	dir = 1
	},
/turf/open/floor/carpet/black,
/area/station/service/chapel)
"Im" = (
/obj/machinery/camera{
	c_tag = "Testing Lab East";
	network = list("ss13","rd")
	},
/turf/open/floor/plasteel/stairs/goon/dark_stairs_wide{
	dir = 4
	},
/area/station/service/chapel)
"IL" = (
/turf/open/floor/carpet/red,
/area/station/service/chapel)
"IS" = (
/obj/machinery/atmospherics/components/unary/vent_scrubber/on/layer4{
	dir = 8
	},
/obj/structure/cable{
	icon_state = "0-8"
	},
/obj/machinery/power/apc{
	areastring = "/area/chapel/office";
	name = "Chapel Office APC";
	pixel_y = -23
	},
/obj/machinery/camera{
	c_tag = "Chapel Crematorium";
	dir = 1
	},
/turf/open/floor/plasteel/dark,
/area/station/service/chapel/office)
"Jc" = (
/obj/structure/closet/crate/coffin,
/obj/structure/window/reinforced{
	dir = 4
	},
/turf/open/floor/plasteel/dark,
/area/station/service/chapel/office)
"Jj" = (
/obj/structure/cable{
	icon_state = "1-2"
	},
/obj/machinery/atmospherics/pipe/simple/supply/hidden/layer2,
/obj/machinery/atmospherics/pipe/simple/scrubbers/hidden/layer4{
	dir = 1
	},
/obj/machinery/door/firedoor/border_only{
	dir = 1
	},
/obj/machinery/door/firedoor/border_only,
/obj/structure/disposalpipe/segment,
/obj/machinery/door/airlock/public/glass{
	name = "Chapel Office"
	},
/obj/effect/mapping_helpers/airlock/access/all/service/chapel_office,
/turf/open/floor/plasteel/dark,
/area/station/service/chapel/office)
"Kc" = (
/obj/item/toy/figure/chaplain,
/obj/item/clothing/under/rank/civilian/chaplain/burial,
/obj/item/clothing/under/rank/civilian/chaplain/burial,
/obj/item/clothing/under/rank/civilian/chaplain/burial,
/obj/item/clothing/under/rank/civilian/chaplain/burial,
/obj/item/clothing/under/rank/civilian/chaplain/burial,
/obj/item/clothing/under/rank/civilian/chaplain/burial,
/obj/structure/table/wood/fancy,
/turf/open/floor/carpet/red,
/area/station/service/chapel/office)
"Kn" = (
/obj/structure/closet/crate/coffin,
/obj/machinery/door/window/eastleft{
	dir = 8;
	name = "Coffin Storage"
	},
/obj/effect/mapping_helpers/windoor/access/all/service/chapel_office{
	dir = 8
	},
/turf/open/floor/plasteel/dark,
/area/station/service/chapel/office)
"Kz" = (
/obj/item/flashlight/lamp{
	pixel_y = 10
	},
/obj/structure/table/wood/fancy,
/turf/open/floor/carpet/red,
/area/station/service/chapel/office)
"KA" = (
/obj/structure/railing{
	dir = 4
	},
/turf/open/floor/carpet/red,
/area/station/service/chapel)
"Lo" = (
/obj/effect/spawner/xmastree,
/turf/open/floor/carpet/red,
/area/station/service/chapel)
"LJ" = (
/obj/structure/railing,
/obj/structure/table/wood/fancy,
/obj/structure/cable{
	icon_state = "1-2"
	},
/obj/structure/disposalpipe/segment,
/turf/open/floor/carpet/red,
/area/station/service/chapel)
"LV" = (
/obj/item/paper_bin{
	pixel_x = -2;
	pixel_y = 5
	},
/obj/item/storage/crayons,
/obj/structure/table/wood/fancy,
/turf/open/floor/carpet/red,
/area/station/service/chapel/office)
"Nh" = (
/obj/machinery/airalarm{
	pixel_y = 24
	},
/turf/open/floor/plasteel/dark,
/area/station/service/chapel/office)
"Nz" = (
/obj/structure/railing,
/obj/structure/table/altar_of_gods,
/turf/open/floor/carpet/red,
/area/station/service/chapel)
"NN" = (
/obj/item/radio/intercom{
	pixel_y = 25
	},
/obj/machinery/atmospherics/components/unary/vent_pump/on/layer2{
	dir = 4
	},
/turf/open/floor/carpet/red,
/area/station/service/chapel/office)
"Og" = (
/obj/machinery/atmospherics/pipe/simple/scrubbers/hidden/layer4{
	dir = 8
	},
/turf/open/floor/plasteel/dark,
/area/station/service/chapel)
"Oi" = (
/turf/open/floor/plasteel/chapel{
	dir = 8
	},
/area/station/service/chapel)
"Ph" = (
/obj/structure/chair/wood/normal{
	dir = 8
	},
/turf/open/floor/plasteel/dark,
/area/station/service/chapel)
"Pv" = (
/obj/machinery/atmospherics/pipe/simple/supply/hidden/layer2{
	dir = 8
	},
/turf/open/floor/carpet/black,
/area/station/service/chapel)
"Qb" = (
/obj/structure/chair/pew/right{
	dir = 1
	},
/turf/open/floor/plasteel/chapel,
/area/station/service/chapel)
"QD" = (
/obj/machinery/light,
/obj/machinery/atmospherics/pipe/simple/supply/hidden/layer2{
	dir = 9
	},
/turf/open/floor/plasteel/dark,
/area/station/service/chapel)
"QO" = (
/turf/open/floor/plasteel/chapel{
	dir = 1
	},
/area/station/service/chapel)
"Ra" = (
/obj/machinery/door/airlock/public/glass{
	name = "Chapel"
	},
/obj/machinery/door/firedoor/border_only{
	dir = 4
	},
/obj/machinery/door/firedoor/border_only{
	dir = 8
	},
/turf/open/floor/plasteel/dark,
/area/station/service/chapel)
"Rp" = (
/obj/structure/closet/crate/coffin,
/obj/structure/window/reinforced{
	dir = 8
	},
/turf/open/floor/plasteel/dark,
/area/station/service/chapel/office)
"Rs" = (
/obj/machinery/atmospherics/pipe/simple/supply/hidden/layer2{
	dir = 8
	},
/turf/open/floor/plasteel/chapel{
	dir = 4
	},
/area/station/service/chapel)
"Sq" = (
/obj/structure/closet/crate/coffin,
/obj/machinery/door/window/eastleft{
	name = "Coffin Storage"
	},
/obj/effect/mapping_helpers/windoor/access/all/service/chapel_office{
	dir = 4
	},
/turf/open/floor/plasteel/dark,
/area/station/service/chapel/office)
"SV" = (
/obj/structure/chair/pew/left{
	dir = 1
	},
/turf/open/floor/plasteel/chapel{
	dir = 8
	},
/area/station/service/chapel)
"Tc" = (
/obj/structure/railing{
	dir = 4
	},
/turf/open/floor/plasteel/stairs/goon/dark_stairs_wide2{
	dir = 1
	},
/area/station/service/chapel)
"Te" = (
/obj/structure/disposalpipe/segment{
	dir = 4
	},
/obj/structure/cable{
	icon_state = "4-8"
	},
/obj/effect/turf_decal/stripes/line{
	dir = 8
	},
/obj/machinery/atmospherics/pipe/simple/supply/hidden/layer2{
	dir = 4
	},
/obj/machinery/atmospherics/pipe/simple/scrubbers/hidden/layer4{
	dir = 4
	},
/obj/machinery/button/crematorium{
	id = "crematoriumChapel";
	pixel_y = -25
	},
/turf/open/floor/plasteel/dark,
/area/station/service/chapel/office)
"TA" = (
/obj/effect/turf_decal/stripes/corner{
	dir = 8
	},
/obj/structure/bodycontainer/crematorium{
	dir = 4;
	id = "crematoriumChapel"
	},
/turf/open/floor/plasteel/dark,
/area/station/service/chapel/office)
"TD" = (
/obj/structure/table/wood/fancy,
/turf/open/floor/plasteel/dark,
/area/station/service/chapel)
"UA" = (
/obj/effect/turf_decal/siding/wideplating{
	dir = 1
	},
/obj/effect/turf_decal/ramp_middle,
/turf/open/floor/plasteel/chapel{
	dir = 4
	},
/area/station/service/chapel)
"Vd" = (
/obj/machinery/firealarm{
	dir = 4;
	pixel_x = -26
	},
/turf/open/floor/plasteel/chapel{
	dir = 8
	},
/area/station/service/chapel)
"Ve" = (
/obj/structure/cable{
	icon_state = "4-8"
	},
/obj/machinery/atmospherics/pipe/simple/supply/hidden/layer2{
	dir = 8
	},
/obj/machinery/atmospherics/pipe/simple/scrubbers/hidden/layer4{
	dir = 5
	},
/obj/structure/disposalpipe/segment{
	dir = 4
	},
/turf/open/floor/plasteel/dark,
/area/station/service/chapel)
"VJ" = (
/obj/machinery/disposal/bin,
/obj/structure/disposalpipe/trunk{
	dir = 4
	},
/turf/open/floor/carpet/black,
/area/station/service/chapel/office)
"VX" = (
/obj/structure/cable{
	icon_state = "1-4";
	tag = ""
	},
/obj/machinery/atmospherics/pipe/simple/supply/hidden/layer2{
	dir = 8
	},
/obj/structure/disposalpipe/segment{
	dir = 5
	},
/turf/open/floor/carpet/black,
/area/station/service/chapel)
"Wl" = (
/obj/structure/railing{
	dir = 4
	},
/obj/structure/table/wood/fancy,
/obj/item/flashlight/lantern,
/turf/open/floor/carpet/red,
/area/station/service/chapel)
"Wp" = (
/obj/machinery/light,
/turf/open/floor/carpet/black,
/area/station/service/chapel)
"WA" = (
/obj/structure/disposalpipe/segment{
	dir = 10
	},
/obj/structure/cable{
	icon_state = "2-8"
	},
/obj/machinery/atmospherics/pipe/manifold/supply/hidden/layer2{
	dir = 4
	},
/obj/structure/cable{
	icon_state = "4-8"
	},
/obj/machinery/atmospherics/pipe/manifold/scrubbers/hidden/layer4{
	dir = 1
	},
/turf/open/floor/plasteel/dark,
/area/station/service/chapel/office)
"WH" = (
/obj/structure/table/wood/fancy,
/obj/machinery/light/small{
	dir = 4
	},
/turf/open/floor/carpet/red,
/area/station/service/chapel)
"XU" = (
/obj/structure/spirit_board,
/obj/machinery/power/apc{
	areastring = "/area/chapel/main";
	dir = 4;
	name = "Chapel APC";
	pixel_x = 24
	},
/obj/structure/cable{
	icon_state = "0-8"
	},
/turf/open/floor/carpet/black,
/area/station/service/chapel/office)
"Yf" = (
/obj/structure/cable{
	icon_state = "4-8"
	},
/obj/machinery/atmospherics/pipe/simple/supply/hidden/layer2{
	dir = 8
	},
/obj/structure/disposalpipe/segment{
	dir = 4
	},
/turf/open/floor/plasteel/chapel{
	dir = 4
	},
/area/station/service/chapel)
"Yp" = (
/obj/structure/cable{
	icon_state = "4-8"
	},
/obj/machinery/atmospherics/pipe/simple/supply/hidden/layer2{
	dir = 8
	},
/obj/structure/disposalpipe/segment{
	dir = 4
	},
/turf/open/floor/plasteel/chapel{
	dir = 1
	},
/area/station/service/chapel)
"Yv" = (
/obj/machinery/light_switch{
	pixel_y = 28
	},
/turf/open/floor/carpet/black,
/area/station/service/chapel)
"YY" = (
/obj/structure/railing,
/obj/structure/table/wood/fancy,
/turf/open/floor/carpet/red,
/area/station/service/chapel)
"Zp" = (
/obj/structure/disposalpipe/segment,
/obj/structure/cable{
	icon_state = "1-2"
	},
/obj/machinery/door/airlock{
	name = "Crematorium"
	},
/obj/structure/cable{
	icon_state = "1-2"
	},
/obj/machinery/atmospherics/pipe/simple/supply/hidden/layer2,
/obj/machinery/atmospherics/pipe/simple/scrubbers/hidden/layer4,
/obj/machinery/door/firedoor/border_only,
/obj/machinery/door/firedoor/border_only{
	dir = 1
	},
/obj/effect/mapping_helpers/airlock/access/all/service/crematorium,
/turf/open/floor/plasteel/dark,
/area/station/service/chapel/office)
"Zw" = (
/obj/structure/cable{
	icon_state = "1-2"
	},
/obj/machinery/atmospherics/pipe/manifold/supply/hidden/layer2{
	dir = 4
	},
/obj/machinery/atmospherics/pipe/manifold/scrubbers/hidden/layer4{
	dir = 8
	},
/obj/structure/disposalpipe/segment,
/turf/open/floor/carpet/red,
/area/station/service/chapel/office)
"ZW" = (
/obj/machinery/atmospherics/components/unary/vent_scrubber/on/layer4{
	dir = 8
	},
/turf/open/floor/plasteel/chapel{
	dir = 8
	},
/area/station/service/chapel)

(1,1,1) = {"
kI
kI
kI
kI
xL
xL
xL
xL
xL
xL
kI
kI
kI
kI
kI
kI
kI
kI
kI
kI
"}
(2,1,1) = {"
kI
kI
kI
kI
xL
Cq
aW
pf
zA
xL
kI
kI
kI
kI
kI
kI
kI
kI
kI
kI
"}
(3,1,1) = {"
kI
kI
kI
kI
gJ
ER
QD
xL
jk
xL
kI
kI
kI
kI
kI
kI
kI
kI
kI
kI
"}
(4,1,1) = {"
kI
kI
kI
xL
xL
Og
sy
Dj
Dq
xL
kI
kI
kI
kI
kI
kI
kI
kI
kI
kI
"}
(5,1,1) = {"
kI
kI
kI
xL
ym
rG
ym
xL
WH
xL
kI
kI
kI
kI
kI
kI
kI
kI
kI
kI
"}
(6,1,1) = {"
kI
kI
kI
xL
Im
FB
iO
xL
xL
xL
xL
xL
xL
xL
xL
xL
Ra
Ra
xL
xL
"}
(7,1,1) = {"
kI
kI
kI
xL
He
Oi
QO
Oi
QO
Oi
QO
Vd
gB
CG
DV
iB
iR
gL
Cq
xL
"}
(8,1,1) = {"
kI
kI
kI
xL
qK
EV
qK
EV
qK
dC
qK
EV
Hp
qy
qZ
zX
SV
za
SV
dR
"}
(9,1,1) = {"
kI
kI
kI
zg
Rp
Rp
Kn
zg
bt
Pv
FD
fD
ds
bA
vK
UA
Qb
Rs
Qb
dR
"}
(10,1,1) = {"
zg
zg
ln
zg
Sq
Jc
Jc
zg
Ia
Pv
FD
IL
IL
IL
YY
as
FD
Pv
FD
dR
"}
(11,1,1) = {"
zg
TA
Te
zg
NN
Kc
VJ
zg
rx
Pv
FD
Lo
IL
mq
Nz
as
FD
Pv
Wp
xL
"}
(12,1,1) = {"
zg
to
WA
Zp
Zw
GD
gc
Jj
Gs
ED
by
Cz
Cz
Cz
LJ
aH
by
VX
FD
dR
"}
(13,1,1) = {"
zg
Nh
IS
zg
Cv
im
gr
zg
Yv
sK
FD
EO
KA
Wl
oG
hp
SV
Yp
SV
dR
"}
(14,1,1) = {"
zg
Fz
oS
zg
xr
LV
gr
oK
QO
ZW
QO
Oi
yO
zf
iZ
EZ
Qb
Yf
Qb
dR
"}
(15,1,1) = {"
zg
kK
zg
zg
cB
Gn
jb
oK
qK
EV
qK
EV
Tc
kU
Df
sy
tP
Ve
Cq
xL
"}
(16,1,1) = {"
FN
DX
an
zg
cC
Kz
XU
oK
Ph
TD
DL
wD
xL
xL
xL
xL
Ra
dd
xL
xL
"}
(17,1,1) = {"
zg
zg
zg
wA
wA
wA
wA
wA
wA
wA
wA
wA
wA
kI
kI
kI
kI
kI
kI
kI
"}
