//MAP CONVERTED BY dmm2tgm.py THIS HEADER COMMENT PREVENTS RECONVERSION, DO NOT REMOVE
"b" = (
/obj/structure/chair/stool,
/obj/machinery/atmospherics/pipe/simple/scrubbers/hidden/layer4{
	dir = 10
	},
/turf/open/floor/carpet/black,
/area/station/service/gift_shop)
"c" = (
/obj/structure/sign/poster/official/random{
	pixel_x = 32
	},
/obj/machinery/airalarm{
	dir = 1;
	pixel_y = -24
	},
/turf/open/floor/wood,
/area/station/service/gift_shop)
"d" = (
/obj/machinery/atmospherics/components/unary/vent_pump/on/layer2{
	dir = 4
	},
/turf/open/floor/wood,
/area/station/service/gift_shop)
"e" = (
/obj/machinery/camera{
	c_tag = "Clerk's Gambling Hall"
	},
/turf/open/floor/wood,
/area/station/service/gift_shop)
"f" = (
/obj/machinery/light_switch{
	pixel_y = 25
	},
/turf/open/floor/wood,
/area/station/service/gift_shop)
"g" = (
/obj/structure/table/wood/poker,
/obj/machinery/door/poddoor/shutters{
	id = "gamblinghall"
	},
/turf/open/floor/carpet/black,
/area/station/service/gift_shop)
"h" = (
/obj/machinery/vending/gifts,
/turf/open/floor/wood,
/area/station/service/gift_shop)
"i" = (
/obj/effect/spawner/structure/window,
/obj/machinery/door/poddoor/shutters/preopen{
	id = "gamblinghall_ext"
	},
/turf/open/floor/plating,
/area/station/service/gift_shop)
"j" = (
/turf/template_noop,
/area/template_noop)
"k" = (
/obj/machinery/atmospherics/pipe/manifold/scrubbers/hidden/layer4{
	dir = 4
	},
/obj/machinery/atmospherics/pipe/simple/supply/hidden/layer2,
/turf/open/floor/wood,
/area/station/service/gift_shop)
"l" = (
/obj/machinery/atmospherics/components/unary/vent_pump/on/layer2{
	dir = 8
	},
/turf/open/floor/wood,
/area/station/service/gift_shop)
"m" = (
/obj/structure/chair,
/turf/open/floor/carpet/black,
/area/station/service/gift_shop)
"n" = (
/obj/machinery/atmospherics/pipe/simple/scrubbers/hidden/layer4,
/obj/machinery/atmospherics/pipe/simple/supply/hidden/layer2,
/turf/open/floor/wood,
/area/station/service/gift_shop)
"p" = (
/obj/machinery/firealarm{
	dir = 1;
	pixel_y = -28
	},
/turf/open/floor/wood,
/area/station/service/gift_shop)
"q" = (
/obj/machinery/power/apc{
	areastring = "/area/clerk";
	dir = 1;
	name = "Gift Shop APC";
	pixel_y = 23
	},
/obj/structure/cable{
	icon_state = "0-8"
	},
/obj/machinery/atmospherics/pipe/simple/supply/hidden/layer2{
	dir = 4
	},
/turf/open/floor/wood,
/area/station/service/gift_shop)
"s" = (
/obj/machinery/vending/cigarette,
/turf/open/floor/wood,
/area/station/service/gift_shop)
"t" = (
/obj/machinery/atmospherics/components/unary/vent_scrubber/on/layer4{
	dir = 1
	},
/turf/open/floor/wood,
/area/station/service/gift_shop)
"u" = (
/obj/structure/chair/stool,
/obj/machinery/airalarm{
	dir = 8;
	pixel_x = 24
	},
/turf/open/floor/wood,
/area/station/service/gift_shop)
"w" = (
/obj/structure/chair/stool,
/obj/structure/extinguisher_cabinet{
	pixel_x = 27
	},
/turf/open/floor/carpet/black,
/area/station/service/gift_shop)
"x" = (
/obj/machinery/vending/coffee,
/obj/machinery/light{
	dir = 8
	},
/turf/open/floor/wood,
/area/station/service/gift_shop)
"y" = (
/mob/living/simple_animal/spiffles,
/turf/open/floor/wood,
/area/station/service/gift_shop)
"z" = (
/obj/machinery/door/firedoor/border_only{
	dir = 1
	},
/obj/machinery/door/firedoor/border_only,
/obj/machinery/door/airlock{
	name = "Gambling Hall"
	},
/obj/machinery/door/poddoor/shutters/preopen{
	id = "gamblinghall_ext"
	},
/turf/open/floor/wood,
/area/station/service/gift_shop)
"A" = (
/obj/machinery/light{
	dir = 4
	},
/turf/open/floor/carpet/black,
/area/station/service/gift_shop)
"B" = (
/obj/machinery/door/firedoor/border_only,
/obj/machinery/door/firedoor/border_only{
	dir = 1
	},
/obj/machinery/door/airlock{
	name = "Gambling Hall"
	},
/obj/machinery/door/poddoor/shutters/preopen{
	id = "gamblinghall_ext"
	},
/turf/open/floor/wood,
/area/station/service/gift_shop)
"C" = (
/obj/structure/chair/stool,
/turf/open/floor/carpet/black,
/area/station/service/gift_shop)
"D" = (
/obj/machinery/door/poddoor/shutters/preopen{
	id = "gamblinghall_ext"
	},
/obj/effect/spawner/structure/window,
/turf/open/floor/plating,
/area/station/service/gift_shop)
"E" = (
/obj/machinery/firealarm{
	pixel_y = 28
	},
/obj/structure/cable{
	icon_state = "4-8"
	},
/obj/machinery/atmospherics/pipe/simple/supply/hidden/layer2{
	dir = 4
	},
/turf/open/floor/wood,
/area/station/service/gift_shop)
"F" = (
/obj/machinery/vending/autodrobe,
/turf/open/floor/wood,
/area/station/service/gift_shop)
"G" = (
/turf/closed/wall,
/area/station/service/gift_shop)
"H" = (
/turf/open/floor/wood,
/area/station/service/gift_shop)
"I" = (
/obj/machinery/vending/games,
/obj/machinery/light{
	dir = 1
	},
/turf/open/floor/wood,
/area/station/service/gift_shop)
"J" = (
/obj/machinery/vending/cola/random,
/turf/open/floor/wood,
/area/station/service/gift_shop)
"K" = (
/obj/item/storage/secure/safe{
	pixel_x = 5;
	pixel_y = -25
	},
/turf/open/floor/carpet/black,
/area/station/service/gift_shop)
"L" = (
/obj/machinery/atmospherics/pipe/simple/scrubbers/hidden/layer4{
	dir = 5
	},
/obj/machinery/atmospherics/pipe/simple/supply/hidden/layer2{
	dir = 9
	},
/turf/open/floor/wood,
/area/station/service/gift_shop)
"N" = (
/obj/structure/table/wood,
/obj/machinery/paystand/register{
	dir = 1
	},
/obj/machinery/light{
	dir = 8
	},
/turf/open/floor/wood,
/area/station/service/gift_shop)
"O" = (
/obj/structure/cable{
	icon_state = "1-4"
	},
/obj/machinery/atmospherics/pipe/simple/scrubbers/hidden/layer4,
/obj/machinery/atmospherics/pipe/manifold/supply/hidden/layer2{
	dir = 8
	},
/turf/open/floor/wood,
/area/station/service/gift_shop)
"P" = (
/obj/structure/table/wood,
/obj/item/a_gift{
	pixel_x = -5;
	pixel_y = -2
	},
/obj/item/a_gift{
	pixel_x = 7;
	pixel_y = 4
	},
/turf/open/floor/wood,
/area/station/service/gift_shop)
"Q" = (
/obj/machinery/atmospherics/pipe/simple/scrubbers/hidden/layer4{
	dir = 4
	},
/turf/open/floor/carpet/black,
/area/station/service/gift_shop)
"R" = (
/obj/machinery/door/airlock{
	name = "Gambling Hall"
	},
/obj/machinery/door/firedoor/border_only,
/obj/machinery/door/firedoor/border_only{
	dir = 1
	},
/obj/machinery/atmospherics/pipe/simple/scrubbers/hidden/layer4,
/obj/machinery/atmospherics/pipe/simple/supply/hidden/layer2,
/obj/structure/cable{
	icon_state = "1-2"
	},
/obj/effect/mapping_helpers/airlock/access/all/service/clerk,
/turf/open/floor/wood,
/area/station/service/gift_shop)
"S" = (
/obj/structure/chair/stool,
/obj/machinery/atmospherics/pipe/simple/scrubbers/hidden/layer4{
	dir = 4
	},
/turf/open/floor/carpet/black,
/area/station/service/gift_shop)
"T" = (
/obj/machinery/door/firedoor/border_only,
/obj/machinery/door/firedoor/border_only{
	dir = 1
	},
/obj/machinery/door/airlock{
	name = "Gambling Hall"
	},
/obj/machinery/atmospherics/pipe/simple/scrubbers/hidden/layer4,
/obj/machinery/atmospherics/pipe/simple/supply/hidden/layer2,
/obj/effect/mapping_helpers/airlock/access/all/service/clerk,
/turf/open/floor/wood,
/area/station/service/gift_shop)
"U" = (
/obj/structure/table/wood/poker,
/obj/machinery/door/poddoor/shutters{
	id = "gamblinghall"
	},
/obj/item/toy/cards/deck,
/turf/open/floor/carpet/black,
/area/station/service/gift_shop)
"V" = (
/turf/open/floor/carpet/black,
/area/station/service/gift_shop)
"W" = (
/obj/structure/table/wood,
/obj/item/coinstack,
/obj/item/coin/gold,
/obj/item/coin/gold,
/obj/item/coin/gold,
/obj/item/coin/plasma,
/obj/item/coin/uranium,
/obj/item/coin/diamond,
/obj/item/coin/iron,
/obj/item/coin/iron,
/turf/open/floor/carpet/black,
/area/station/service/gift_shop)
"X" = (
/obj/structure/chair/stool,
/obj/machinery/light{
	dir = 1
	},
/turf/open/floor/carpet/black,
/area/station/service/gift_shop)
"Y" = (
/obj/effect/landmark/start/yogs/clerk,
/turf/open/floor/carpet/black,
/area/station/service/gift_shop)
"Z" = (
/obj/machinery/atmospherics/components/unary/vent_scrubber/on/layer4{
	dir = 4
	},
/obj/machinery/button/door{
	id = "gamblinghall";
	name = "Gift Shop Internal Shutters";
	pixel_x = -6;
	pixel_y = -24
	},
/obj/machinery/button/door{
	id = "gamblinghall_ext";
	name = "Gift Shop External Shutters";
	pixel_x = 6;
	pixel_y = -24
	},
/turf/open/floor/wood,
/area/station/service/gift_shop)

(1,1,1) = {"
j
G
G
G
G
G
G
G
G
"}
(2,1,1) = {"
j
G
P
N
G
J
x
s
G
"}
(3,1,1) = {"
j
G
f
Z
G
e
d
H
D
"}
(4,1,1) = {"
j
R
O
k
T
n
L
H
z
"}
(5,1,1) = {"
j
G
E
K
G
X
Q
H
i
"}
(6,1,1) = {"
G
G
q
V
U
g
S
H
B
"}
(7,1,1) = {"
G
h
l
Y
m
g
b
t
i
"}
(8,1,1) = {"
G
I
y
V
g
g
C
p
G
"}
(9,1,1) = {"
G
F
u
W
G
w
A
c
G
"}
(10,1,1) = {"
G
G
G
G
G
G
G
G
G
"}
