//MAP CONVERTED BY dmm2tgm.py THIS HEADER COMMENT PREVENTS RECONVERSION, DO NOT REMOVE
"aa" = (
/turf/open/space/basic,
/area/space)
"ab" = (
/turf/template_noop,
/area/template_noop)
"ac" = (
/turf/open/floor/plasteel,
/area/station/engineering/main)
"ad" = (
/turf/closed/wall/r_wall,
/area/station/engineering/main)
"ae" = (
/obj/structure/table,
/obj/item/clothing/suit/radiation,
/obj/item/clothing/head/radiation,
/obj/item/clothing/glasses/meson,
/turf/open/floor/plasteel,
/area/station/engineering/main)
"ah" = (
/obj/effect/turf_decal/stripes/line{
	dir = 9
	},
/turf/open/floor/engine,
/area/station/engineering/main)
"ai" = (
/obj/effect/turf_decal/stripes/line{
	dir = 1
	},
/turf/open/floor/engine,
/area/station/engineering/main)
"aj" = (
/obj/structure/closet/secure_closet/engineering_personal,
/turf/open/floor/plasteel,
/area/station/engineering/main)
"ak" = (
/obj/effect/turf_decal/stripes/line{
	dir = 5
	},
/turf/open/floor/engine,
/area/station/engineering/main)
"al" = (
/obj/structure/table,
/obj/item/clothing/gloves/color/yellow,
/obj/item/storage/toolbox/electrical{
	pixel_y = 5
	},
/turf/open/floor/plasteel,
/area/station/engineering/main)
"an" = (
/obj/machinery/atmospherics/pipe/simple/supply/hidden/layer2{
	dir = 8
	},
/obj/machinery/atmospherics/pipe/simple/scrubbers/hidden/layer4{
	dir = 4
	},
/turf/open/floor/plasteel,
/area/station/engineering/main)
"ap" = (
/obj/machinery/atmospherics/pipe/simple/supply/hidden/layer2{
	dir = 8
	},
/obj/machinery/atmospherics/pipe/simple/scrubbers/hidden/layer4{
	dir = 4
	},
/obj/structure/cable/yellow{
	icon_state = "1-4"
	},
/turf/open/floor/plasteel,
/area/station/engineering/main)
"aq" = (
/obj/structure/grille,
/turf/open/floor/plating/airless,
/area/station/engineering/main)
"ar" = (
/obj/effect/turf_decal/stripes/line{
	dir = 8
	},
/turf/open/floor/engine,
/area/station/engineering/main)
"as" = (
/turf/open/floor/engine,
/area/station/engineering/main)
"au" = (
/obj/structure/particle_accelerator/fuel_chamber,
/turf/open/floor/engine,
/area/station/engineering/main)
"av" = (
/obj/machinery/atmospherics/pipe/simple/orange/hidden{
	dir = 9
	},
/turf/closed/wall,
/area/station/engineering/main)
"aw" = (
/obj/machinery/door/poddoor/shutters/preopen{
	id = "engsm";
	name = "Radiation Chamber Shutters"
	},
/obj/machinery/door/poddoor/shutters/preopen{
	id = "engsm";
	name = "Radiation Chamber Shutters"
	},
/obj/machinery/door/firedoor/border_only,
/obj/machinery/door/firedoor/border_only{
	dir = 1
	},
/turf/open/floor/plating,
/area/station/engineering/main)
"aD" = (
/obj/structure/table,
/obj/item/storage/toolbox/mechanical{
	pixel_y = 5
	},
/obj/item/flashlight{
	pixel_x = 1;
	pixel_y = 5
	},
/obj/item/flashlight{
	pixel_x = 1;
	pixel_y = 5
	},
/obj/effect/turf_decal/stripes/line,
/turf/open/floor/plasteel,
/area/station/engineering/main)
"aE" = (
/obj/effect/turf_decal/stripes/line,
/turf/open/floor/plasteel,
/area/station/engineering/main)
"aF" = (
/obj/machinery/door/poddoor/shutters/preopen{
	id = "engsm";
	name = "Radiation Chamber Shutters"
	},
/obj/effect/spawner/structure/window/reinforced,
/turf/open/floor/plating,
/area/station/engineering/main)
"aG" = (
/obj/effect/turf_decal/stripes/line{
	dir = 4
	},
/turf/open/floor/engine,
/area/station/engineering/main)
"aI" = (
/obj/machinery/door/poddoor/shutters/preopen{
	id = "engsm";
	name = "Radiation Chamber Shutters"
	},
/obj/machinery/door/firedoor/border_only,
/obj/machinery/door/firedoor/border_only{
	dir = 1
	},
/turf/open/floor/plating,
/area/station/engineering/main)
"aL" = (
/obj/structure/particle_accelerator/power_box,
/turf/open/floor/engine,
/area/station/engineering/main)
"aO" = (
/obj/structure/particle_accelerator/particle_emitter/left,
/turf/open/floor/engine,
/area/station/engineering/main)
"aP" = (
/obj/structure/particle_accelerator/particle_emitter/center,
/turf/open/floor/engine,
/area/station/engineering/main)
"aQ" = (
/obj/structure/lattice,
/turf/open/space/basic,
/area/space/nearstation)
"aR" = (
/turf/open/floor/plating/airless,
/area/space/nearstation)
"aU" = (
/obj/structure/sign/warning/electricshock,
/turf/closed/wall/r_wall,
/area/station/engineering/main)
"ba" = (
/obj/structure/particle_accelerator/particle_emitter/right,
/turf/open/floor/engine,
/area/station/engineering/main)
"bb" = (
/turf/closed/wall,
/area/station/engineering/main)
"bf" = (
/obj/effect/turf_decal/stripes/line{
	dir = 10
	},
/turf/open/floor/engine,
/area/station/engineering/main)
"bg" = (
/obj/effect/turf_decal/stripes/line,
/turf/open/floor/engine,
/area/station/engineering/main)
"bh" = (
/obj/effect/turf_decal/stripes/line{
	dir = 6
	},
/turf/open/floor/engine,
/area/station/engineering/main)
"bm" = (
/obj/machinery/power/tesla_coil,
/turf/open/floor/plating/airless,
/area/station/engineering/main)
"bu" = (
/obj/structure/grille,
/turf/open/floor/plating/airless,
/area/space/nearstation)
"bx" = (
/obj/structure/closet/radiation,
/turf/open/floor/plasteel,
/area/station/engineering/main)
"bz" = (
/obj/machinery/particle_accelerator/control_box,
/obj/structure/cable/yellow,
/turf/open/floor/engine,
/area/station/engineering/main)
"bA" = (
/obj/effect/turf_decal/stripes/line{
	dir = 8
	},
/obj/item/stack/cable_coil/red,
/obj/item/crowbar,
/turf/open/floor/engine,
/area/station/engineering/main)
"bB" = (
/obj/item/screwdriver,
/turf/open/floor/engine,
/area/station/engineering/main)
"bF" = (
/obj/structure/cable/yellow{
	icon_state = "1-2"
	},
/obj/machinery/atmospherics/components/unary/vent_scrubber/on/layer4{
	dir = 1
	},
/turf/open/floor/plasteel,
/area/station/engineering/main)
"bG" = (
/obj/machinery/atmospherics/components/unary/vent_pump/on/layer2{
	dir = 1;
	icon_state = "vent_map_on-1"
	},
/obj/machinery/button/door{
	dir = 4;
	id = "engsm";
	name = "Radiation Shutters Control";
	pixel_x = 24;
	pixel_y = 0;
	req_access = list("engineering")
	},
/turf/open/floor/plasteel,
/area/station/engineering/main)
"bH" = (
/obj/structure/chair/stool,
/turf/open/floor/plasteel,
/area/station/engineering/main)
"bI" = (
/obj/structure/rack,
/obj/item/clothing/gloves/color/black,
/obj/item/extinguisher,
/turf/open/floor/plasteel,
/area/station/engineering/main)
"bK" = (
/obj/structure/rack,
/obj/item/clothing/gloves/color/yellow,
/turf/open/floor/plasteel,
/area/station/engineering/main)
"bL" = (
/obj/effect/turf_decal/stripes/line,
/obj/machinery/light,
/turf/open/floor/plasteel,
/area/station/engineering/main)
"bQ" = (
/obj/machinery/power/grounding_rod,
/turf/open/floor/plating/airless,
/area/station/engineering/main)
"bT" = (
/obj/machinery/atmospherics/components/unary/vent_pump/siphon/layer4{
	dir = 1
	},
/obj/machinery/light_switch{
	pixel_x = 23
	},
/turf/open/floor/plating,
/area/station/engineering/main)
"bW" = (
/obj/machinery/power/rad_collector,
/turf/open/floor/plating/airless,
/area/station/engineering/main)
"bZ" = (
/obj/machinery/camera/emp_proof{
	c_tag = "Engineering Singularity Southwest";
	dir = 1;
	network = list("ss13","engine")
	},
/turf/open/floor/plating/airless,
/area/station/engineering/main)
"ca" = (
/obj/item/tank/internals/emergency_oxygen/engi{
	pixel_x = 5
	},
/obj/item/clothing/gloves/color/black,
/obj/item/clothing/glasses/meson/engine,
/obj/structure/table,
/turf/open/floor/plasteel,
/area/station/engineering/main)
"cb" = (
/obj/structure/cable/yellow{
	icon_state = "4-8"
	},
/turf/open/floor/plasteel,
/area/station/engineering/main)
"cc" = (
/obj/item/storage/toolbox/mechanical,
/obj/item/flashlight,
/obj/item/pipe_dispenser,
/obj/structure/cable/yellow{
	icon_state = "2-8"
	},
/obj/structure/table,
/turf/open/floor/plasteel,
/area/station/engineering/main)
"cd" = (
/obj/structure/table,
/obj/item/book/manual/wiki/engineering_singulo_tesla,
/obj/item/geiger_counter,
/turf/open/floor/plasteel,
/area/station/engineering/main)
"ch" = (
/obj/effect/turf_decal/stripes/line{
	dir = 4
	},
/obj/machinery/button/door{
	dir = 4;
	id = "engsm";
	name = "Radiation Shutters Control";
	pixel_x = 24;
	pixel_y = 0;
	req_access = list("engineering")
	},
/turf/open/floor/engine,
/area/station/engineering/main)
"ci" = (
/obj/machinery/atmospherics/components/unary/vent_pump/on/layer2{
	dir = 1;
	icon_state = "vent_map_on-1"
	},
/obj/machinery/button/door{
	dir = 8;
	id = "engsm";
	name = "Radiation Shutters Control";
	pixel_x = -24;
	pixel_y = 0;
	req_access = list("engineering")
	},
/turf/open/floor/plasteel,
/area/station/engineering/main)
"cj" = (
/obj/machinery/light,
/turf/open/floor/plating/airless,
/area/station/engineering/main)
"ck" = (
/obj/machinery/atmospherics/components/unary/portables_connector/visible{
	dir = 4
	},
/turf/open/floor/plasteel,
/area/station/engineering/main)
"co" = (
/obj/structure/grille,
/obj/structure/cable/orange{
	icon_state = "1-2"
	},
/obj/structure/cable/orange{
	icon_state = "1-4"
	},
/turf/open/floor/plating/airless,
/area/station/engineering/main)
"cs" = (
/obj/item/screwdriver,
/turf/open/space/basic,
/area/station/engineering/main)
"cI" = (
/obj/machinery/power/tesla_coil,
/obj/structure/cable/orange{
	icon_state = "2-4"
	},
/turf/open/floor/plating/airless,
/area/station/engineering/main)
"cU" = (
/obj/machinery/atmospherics/pipe/manifold/supply/hidden/layer2{
	dir = 8
	},
/obj/machinery/atmospherics/pipe/manifold/scrubbers/hidden/layer4{
	dir = 8
	},
/obj/structure/cable/orange{
	icon_state = "1-2"
	},
/turf/open/floor/plasteel,
/area/station/engineering/main)
"du" = (
/obj/structure/sign/warning/radiation/rad_area,
/turf/closed/wall/r_wall,
/area/station/engineering/main)
"dO" = (
/obj/machinery/atmospherics/pipe/simple/supply/hidden/layer2{
	dir = 8
	},
/obj/structure/cable/yellow{
	icon_state = "4-8"
	},
/obj/structure/cable/yellow{
	icon_state = "2-8"
	},
/obj/machinery/atmospherics/pipe/simple/scrubbers/hidden/layer4{
	dir = 10
	},
/turf/open/floor/plasteel,
/area/station/engineering/main)
"fn" = (
/obj/structure/reagent_dispensers/fueltank,
/obj/effect/turf_decal/stripes/line{
	dir = 10
	},
/turf/open/floor/engine,
/area/station/engineering/main)
"gc" = (
/obj/structure/sign/warning/vacuum/external{
	pixel_x = -32
	},
/obj/machinery/atmospherics/pipe/simple/supply/hidden/layer2,
/obj/machinery/atmospherics/pipe/simple/scrubbers/hidden/layer4{
	dir = 5
	},
/obj/structure/cable/orange{
	icon_state = "1-2"
	},
/turf/open/floor/plating,
/area/station/engineering/main)
"ge" = (
/obj/machinery/atmospherics/pipe/simple/supply/hidden/layer2{
	dir = 8
	},
/obj/structure/cable/yellow{
	icon_state = "2-8"
	},
/obj/effect/mapping_helpers/teleport_anchor,
/obj/machinery/atmospherics/pipe/simple/scrubbers/hidden/layer4{
	dir = 6
	},
/turf/open/floor/plasteel,
/area/station/engineering/main)
"gm" = (
/turf/open/space/basic,
/area/station/engineering/main)
"in" = (
/obj/structure/cable/orange{
	icon_state = "1-4"
	},
/turf/open/floor/plating/airless,
/area/station/engineering/main)
"iX" = (
/obj/machinery/camera/emp_proof{
	c_tag = "Engineering Singularity Northwest";
	network = list("ss13","engine")
	},
/turf/open/space/basic,
/area/station/engineering/main)
"je" = (
/obj/structure/grille,
/obj/structure/cable/orange{
	icon_state = "1-4"
	},
/turf/open/floor/plating/airless,
/area/station/engineering/main)
"ji" = (
/obj/structure/cable/yellow{
	icon_state = "0-8"
	},
/turf/open/floor/plating/airless,
/area/station/engineering/main)
"jA" = (
/obj/structure/grille,
/obj/structure/cable/orange{
	icon_state = "1-2"
	},
/turf/open/floor/plating/airless,
/area/station/engineering/main)
"kd" = (
/obj/machinery/atmospherics/components/unary/vent_pump/layer2{
	dir = 1
	},
/obj/machinery/advanced_airlock_controller{
	dir = 4;
	pixel_x = -24
	},
/obj/structure/cable/orange{
	icon_state = "1-2"
	},
/turf/open/floor/plating,
/area/station/engineering/main)
"kt" = (
/obj/machinery/power/emitter/anchored{
	dir = 4;
	state = 2
	},
/obj/structure/cable/orange{
	icon_state = "0-8"
	},
/turf/open/floor/plating/airless,
/area/station/engineering/main)
"kU" = (
/obj/structure/lattice,
/turf/open/space/basic,
/area/station/engineering/main)
"ls" = (
/obj/machinery/atmospherics/pipe/simple/supply/hidden/layer2{
	dir = 8
	},
/obj/structure/cable/yellow{
	icon_state = "4-8"
	},
/turf/open/floor/plasteel,
/area/station/engineering/main)
"mp" = (
/obj/machinery/light/small{
	dir = 8
	},
/obj/structure/closet/emcloset/anchored,
/obj/machinery/atmospherics/pipe/simple/supply/hidden/layer2{
	dir = 6
	},
/turf/open/floor/plating,
/area/station/engineering/main)
"mO" = (
/obj/structure/cable/orange{
	icon_state = "1-8"
	},
/turf/open/floor/plating/airless,
/area/station/engineering/main)
"mP" = (
/obj/item/weldingtool,
/turf/open/space/basic,
/area/station/engineering/main)
"mQ" = (
/obj/structure/closet/emcloset/anchored,
/obj/machinery/light/small{
	dir = 4
	},
/obj/machinery/atmospherics/pipe/simple/scrubbers/hidden/layer4{
	dir = 10
	},
/turf/open/floor/plating,
/area/station/engineering/main)
"oD" = (
/obj/machinery/power/tesla_coil,
/obj/structure/cable/orange{
	icon_state = "1-2"
	},
/turf/open/floor/plating/airless,
/area/station/engineering/main)
"oM" = (
/obj/structure/lattice/catwalk,
/obj/structure/cable/yellow{
	icon_state = "1-8"
	},
/turf/open/space/basic,
/area/station/engineering/main)
"pA" = (
/obj/effect/turf_decal/stripes/line{
	dir = 8
	},
/obj/structure/cable/yellow{
	icon_state = "4-8"
	},
/turf/open/floor/engine,
/area/station/engineering/main)
"qG" = (
/obj/machinery/camera/emp_proof{
	c_tag = "Engineering Singularity Southeast";
	dir = 1;
	network = list("ss13","engine")
	},
/turf/open/floor/plating/airless,
/area/station/engineering/main)
"rw" = (
/obj/structure/particle_accelerator/end_cap,
/obj/structure/cable/yellow{
	icon_state = "4-8"
	},
/turf/open/floor/engine,
/area/station/engineering/main)
"rX" = (
/obj/effect/turf_decal/stripes/line{
	dir = 8
	},
/obj/machinery/button/door{
	dir = 8;
	id = "engsm";
	name = "Radiation Shutters Control";
	pixel_x = -24;
	pixel_y = 0;
	req_access = list("engineering")
	},
/mob/living/simple_animal/opossum/poppy,
/turf/open/floor/engine,
/area/station/engineering/main)
"sd" = (
/obj/machinery/field/generator{
	anchored = 1;
	state = 2
	},
/turf/open/floor/plating/airless,
/area/station/engineering/main)
"sv" = (
/obj/structure/cable/yellow{
	icon_state = "0-4"
	},
/turf/open/floor/plating/airless,
/area/station/engineering/main)
"uo" = (
/obj/structure/grille,
/obj/structure/cable/orange{
	icon_state = "1-8"
	},
/obj/structure/cable/orange{
	icon_state = "1-2"
	},
/turf/open/floor/plating/airless,
/area/station/engineering/main)
"uq" = (
/obj/structure/cable/yellow{
	icon_state = "1-2"
	},
/obj/machinery/atmospherics/components/unary/vent_scrubber/on/layer4{
	dir = 1
	},
/obj/effect/mapping_helpers/teleport_anchor,
/turf/open/floor/plasteel,
/area/station/engineering/main)
"uA" = (
/obj/structure/cable/yellow{
	icon_state = "4-8"
	},
/obj/machinery/door/poddoor/shutters/preopen{
	id = "engsm";
	name = "Radiation Chamber Shutters"
	},
/obj/machinery/door/firedoor/border_only{
	dir = 4
	},
/obj/machinery/door/firedoor/border_only{
	dir = 8
	},
/turf/open/floor/plating,
/area/station/engineering/main)
"wH" = (
/obj/machinery/camera/emp_proof{
	c_tag = "Engineering Singularity Northeast";
	network = list("ss13","engine")
	},
/turf/open/space/basic,
/area/station/engineering/main)
"wN" = (
/obj/machinery/atmospherics/pipe/manifold4w/supply/hidden/layer2,
/obj/machinery/atmospherics/pipe/manifold4w/scrubbers/hidden/layer4,
/obj/structure/cable/orange{
	icon_state = "1-2"
	},
/turf/open/floor/plasteel,
/area/station/engineering/main)
"wO" = (
/obj/effect/turf_decal/stripes/line,
/obj/structure/cable/yellow{
	icon_state = "1-2"
	},
/turf/open/floor/engine,
/area/station/engineering/main)
"xD" = (
/obj/structure/cable/yellow{
	icon_state = "4-8"
	},
/obj/machinery/atmospherics/pipe/simple/supply/hidden/layer2{
	dir = 6
	},
/turf/open/floor/plasteel,
/area/station/engineering/main)
"xH" = (
/obj/machinery/door/airlock/external{
	name = "Engineering External Access"
	},
/obj/effect/mapping_helpers/airlock/access/all/engineering/general,
/turf/open/floor/plating/airless,
/area/station/engineering/main)
"xO" = (
/obj/effect/turf_decal/stripes/line,
/obj/item/wirecutters,
/obj/effect/mapping_helpers/teleport_anchor,
/turf/open/floor/engine,
/area/station/engineering/main)
"yi" = (
/turf/open/floor/plating/airless,
/area/station/engineering/main)
"yN" = (
/obj/structure/lattice/catwalk,
/obj/structure/cable/yellow{
	icon_state = "1-2"
	},
/turf/open/space/basic,
/area/station/engineering/main)
"zz" = (
/obj/machinery/door/airlock/external{
	name = "Engineering External Access"
	},
/obj/effect/mapping_helpers/airlock/cyclelink_helper{
	dir = 1
	},
/obj/structure/cable/orange{
	icon_state = "1-2"
	},
/obj/effect/mapping_helpers/airlock/access/all/engineering/general,
/turf/open/floor/plating,
/area/station/engineering/main)
"Aa" = (
/obj/structure/lattice/catwalk,
/obj/structure/cable/yellow{
	icon_state = "1-2"
	},
/obj/structure/cable/yellow{
	icon_state = "1-8"
	},
/turf/open/space/basic,
/area/station/engineering/main)
"AE" = (
/obj/structure/reagent_dispensers/watertank,
/obj/effect/turf_decal/stripes/line{
	dir = 6
	},
/turf/open/floor/engine,
/area/station/engineering/main)
"Bp" = (
/obj/machinery/atmospherics/components/unary/vent_pump/siphon/layer4{
	dir = 1
	},
/obj/machinery/advanced_airlock_controller{
	dir = 8;
	pixel_x = 24
	},
/obj/structure/cable/orange{
	icon_state = "1-2"
	},
/turf/open/floor/plating,
/area/station/engineering/main)
"BA" = (
/obj/structure/cable/yellow{
	icon_state = "4-8"
	},
/turf/open/floor/engine,
/area/station/engineering/main)
"BI" = (
/obj/machinery/door/poddoor/shutters/preopen{
	id = "engsm";
	name = "Radiation Chamber Shutters"
	},
/obj/structure/cable/yellow{
	icon_state = "4-8"
	},
/obj/machinery/door/firedoor/border_only{
	dir = 4
	},
/obj/machinery/door/firedoor/border_only{
	dir = 8
	},
/turf/open/floor/plating,
/area/station/engineering/main)
"Cw" = (
/obj/structure/cable/yellow{
	icon_state = "4-8"
	},
/obj/machinery/atmospherics/pipe/simple/supply/hidden/layer2{
	dir = 10
	},
/turf/open/floor/plasteel,
/area/station/engineering/main)
"CI" = (
/obj/structure/lattice/catwalk,
/turf/open/space/basic,
/area/station/engineering/main)
"CQ" = (
/obj/structure/grille,
/obj/structure/cable/orange{
	icon_state = "1-8"
	},
/turf/open/floor/plating/airless,
/area/station/engineering/main)
"CU" = (
/obj/effect/turf_decal/stripes/line{
	dir = 4
	},
/obj/structure/cable/yellow{
	icon_state = "4-8"
	},
/turf/open/floor/engine,
/area/station/engineering/main)
"Dc" = (
/obj/effect/turf_decal/stripes/line{
	dir = 1
	},
/obj/effect/turf_decal/stripes/line{
	dir = 1
	},
/obj/machinery/light_switch{
	pixel_x = 23
	},
/turf/open/floor/engine,
/area/station/engineering/main)
"Em" = (
/obj/item/wirecutters,
/turf/open/space/basic,
/area/station/engineering/main)
"GG" = (
/obj/structure/lattice/catwalk,
/obj/structure/cable/yellow{
	icon_state = "1-2"
	},
/obj/structure/cable/yellow{
	icon_state = "1-4"
	},
/turf/open/space/basic,
/area/station/engineering/main)
"GW" = (
/obj/machinery/atmospherics/pipe/simple/supply/hidden/layer2{
	dir = 8
	},
/obj/machinery/atmospherics/pipe/simple/scrubbers/hidden/layer4{
	dir = 4
	},
/obj/machinery/door/firedoor/border_only{
	dir = 8
	},
/obj/machinery/door/firedoor/border_only{
	dir = 4
	},
/obj/machinery/door/airlock/engineering{
	name = "AI Satellite Access"
	},
/obj/effect/mapping_helpers/airlock/access/all/engineering/general,
/turf/open/floor/plasteel,
/area/station/engineering/main)
"Hf" = (
/obj/effect/spawner/structure/window/reinforced,
/turf/open/floor/plating,
/area/station/engineering/main)
"Hy" = (
/obj/structure/sign/warning/vacuum/external{
	pixel_x = 32
	},
/obj/machinery/atmospherics/pipe/simple/scrubbers/hidden/layer4,
/obj/machinery/atmospherics/pipe/simple/supply/hidden/layer2{
	dir = 9
	},
/obj/structure/cable/orange{
	icon_state = "1-2"
	},
/turf/open/floor/plating,
/area/station/engineering/main)
"HU" = (
/obj/machinery/power/emitter/anchored{
	dir = 8;
	state = 2
	},
/obj/structure/cable/orange{
	icon_state = "0-4"
	},
/turf/open/floor/plating/airless,
/area/station/engineering/main)
"Jf" = (
/obj/effect/turf_decal/stripes/corner,
/turf/open/floor/plasteel,
/area/station/engineering/main)
"Jk" = (
/obj/effect/mapping_helpers/airlock/cyclelink_helper,
/obj/machinery/door/airlock/external{
	name = "Engineering External Access"
	},
/obj/machinery/door/firedoor/border_only{
	dir = 1
	},
/obj/machinery/door/firedoor/border_only,
/obj/machinery/atmospherics/pipe/simple/supply/hidden/layer2,
/obj/machinery/atmospherics/pipe/simple/scrubbers/hidden/layer4,
/obj/structure/cable/orange{
	icon_state = "1-2"
	},
/obj/effect/mapping_helpers/airlock/access/all/engineering/general,
/turf/open/floor/plating,
/area/station/engineering/main)
"Jy" = (
/obj/structure/grille,
/obj/structure/cable/orange{
	icon_state = "2-4"
	},
/turf/open/floor/plating/airless,
/area/station/engineering/main)
"Kn" = (
/obj/machinery/power/tesla_coil,
/obj/structure/cable/orange{
	icon_state = "2-8"
	},
/turf/open/floor/plating/airless,
/area/station/engineering/main)
"Mh" = (
/obj/structure/cable/yellow{
	icon_state = "4-8"
	},
/obj/structure/cable/yellow{
	icon_state = "2-8"
	},
/turf/open/floor/engine,
/area/station/engineering/main)
"Mi" = (
/obj/machinery/atmospherics/pipe/simple/supply/hidden/layer2,
/obj/machinery/atmospherics/pipe/simple/scrubbers/hidden/layer4,
/obj/structure/cable/orange{
	icon_state = "1-2"
	},
/turf/open/floor/plasteel,
/area/station/engineering/main)
"ME" = (
/obj/machinery/door/poddoor/shutters/preopen{
	id = "engsm";
	name = "Radiation Chamber Shutters"
	},
/obj/machinery/door/firedoor/window,
/obj/effect/spawner/structure/window/reinforced,
/turf/open/floor/plating,
/area/station/engineering/main)
"MT" = (
/obj/machinery/door/poddoor/shutters/preopen{
	id = "engsm";
	name = "Radiation Chamber Shutters"
	},
/obj/structure/cable/yellow{
	icon_state = "1-2"
	},
/obj/machinery/door/firedoor/window,
/obj/effect/spawner/structure/window/reinforced,
/turf/open/floor/plating,
/area/station/engineering/main)
"Ok" = (
/obj/machinery/atmospherics/components/unary/vent_pump/layer2{
	dir = 1
	},
/obj/machinery/light_switch{
	pixel_x = -23
	},
/turf/open/floor/plating,
/area/station/engineering/main)
"On" = (
/obj/structure/grille,
/obj/structure/cable/orange{
	icon_state = "2-8"
	},
/turf/open/floor/plating/airless,
/area/station/engineering/main)
"Oz" = (
/obj/structure/lattice/catwalk,
/obj/structure/cable/yellow{
	icon_state = "1-4"
	},
/turf/open/space/basic,
/area/station/engineering/main)
"Rj" = (
/obj/item/wrench,
/turf/open/space/basic,
/area/station/engineering/main)
"Rw" = (
/obj/machinery/power/rad_collector,
/obj/structure/cable/orange{
	icon_state = "1-4"
	},
/turf/open/floor/plating/airless,
/area/station/engineering/main)
"Sg" = (
/obj/machinery/power/grounding_rod,
/obj/machinery/light{
	dir = 8
	},
/obj/structure/cable/orange{
	icon_state = "1-2"
	},
/turf/open/floor/plating/airless,
/area/station/engineering/main)
"SH" = (
/obj/machinery/power/rad_collector,
/obj/structure/cable/orange{
	icon_state = "1-2"
	},
/turf/open/floor/plating/airless,
/area/station/engineering/main)
"Ty" = (
/obj/effect/turf_decal/stripes/line{
	dir = 1
	},
/obj/machinery/light{
	dir = 1;
	light_color = "#c1caff"
	},
/obj/machinery/camera/emp_proof{
	c_tag = "Engineering Particle Accelerator";
	network = list("ss13","engine")
	},
/obj/effect/mapping_helpers/teleport_anchor,
/turf/open/floor/engine,
/area/station/engineering/main)
"Uz" = (
/obj/effect/turf_decal/stripes/corner{
	dir = 8;
	icon_state = "warninglinecorner"
	},
/turf/open/floor/plasteel,
/area/station/engineering/main)
"VD" = (
/obj/machinery/power/rad_collector,
/obj/structure/cable/orange{
	icon_state = "1-8"
	},
/turf/open/floor/plating/airless,
/area/station/engineering/main)
"VT" = (
/obj/machinery/power/grounding_rod,
/obj/machinery/light{
	dir = 4
	},
/obj/structure/cable/orange{
	icon_state = "1-2"
	},
/turf/open/floor/plating/airless,
/area/station/engineering/main)
"WN" = (
/obj/structure/sign/warning/securearea,
/turf/closed/wall/r_wall,
/area/station/engineering/main)
"WS" = (
/obj/effect/turf_decal/stripes/line{
	dir = 1
	},
/obj/machinery/light_switch{
	pixel_x = -23
	},
/turf/open/floor/engine,
/area/station/engineering/main)
"Zr" = (
/obj/structure/cable/yellow{
	icon_state = "1-2"
	},
/obj/effect/turf_decal/stripes/line{
	dir = 1
	},
/turf/open/floor/engine,
/area/station/engineering/main)

(1,1,1) = {"
ab
ab
ab
ab
ab
ab
ab
aa
aa
aa
aa
aa
aa
aa
aa
aa
aa
aa
aa
aa
aa
ab
ab
ab
ab
ab
"}
(2,1,1) = {"
ab
ab
ab
ab
ab
ab
ab
aa
aa
aa
aa
aa
aa
aa
aa
aa
aa
aa
aa
aa
aa
ab
ab
ab
ab
ab
"}
(3,1,1) = {"
ab
ab
ab
ab
ab
ab
ab
aa
aa
aa
aa
aa
aa
aa
aa
aa
aa
aa
aa
aa
aa
ab
ab
ab
ab
ab
"}
(4,1,1) = {"
ab
ab
ab
ab
ab
ab
ab
aa
aa
aa
aa
aa
aa
aa
aa
aa
aa
aa
aa
aa
aa
ab
ab
ab
ab
ab
"}
(5,1,1) = {"
ab
ab
ab
ab
ab
ab
ab
aQ
aa
aa
aa
aa
aa
aa
aa
aa
aa
aa
aa
aa
aa
ab
ab
ab
ab
ab
"}
(6,1,1) = {"
ab
ab
ab
ab
ab
ab
ab
aR
aQ
aa
aa
aa
aa
aQ
aa
aa
aa
aa
aa
aa
aa
ab
ab
ab
ab
ab
"}
(7,1,1) = {"
ab
ab
ab
ab
bb
bb
ad
ad
ad
ad
ad
ad
ad
du
ad
ad
ad
ad
aU
ad
WN
aQ
aQ
aa
aa
aa
"}
(8,1,1) = {"
ab
ab
al
aD
bb
mp
Ok
ad
Jy
co
jA
je
ad
ad
ad
Jy
jA
je
aq
aq
ad
aa
aa
aa
aa
aa
"}
(9,1,1) = {"
ab
ab
cU
Mi
Jk
Hy
Bp
zz
mO
kt
bm
Kn
oD
Sg
SH
VD
bW
kt
yi
yi
xH
aR
aa
aa
aa
aa
"}
(10,1,1) = {"
ab
cb
an
bL
du
ad
ad
ad
iX
yi
yi
yi
yi
bQ
yi
yi
yi
yi
yi
yi
ad
ad
bu
aa
aa
aa
"}
(11,1,1) = {"
ca
cc
ap
Uz
ah
fn
ad
gm
gm
kU
CI
CI
CI
CI
CI
CI
CI
kU
gm
yi
bZ
ad
bu
aa
aa
aa
"}
(12,1,1) = {"
ac
ac
dO
uq
Zr
wO
MT
yN
yN
yN
GG
yN
yN
GG
yN
yN
Oz
kU
gm
kU
yi
ad
bu
aa
aa
aa
"}
(13,1,1) = {"
ac
ac
ls
bH
ai
bg
ME
gm
gm
kU
ji
yi
kU
ji
gm
yi
ji
kU
gm
kU
cj
ad
bu
aQ
aa
aa
"}
(14,1,1) = {"
aj
bI
Cw
bG
Dc
bg
ME
Hf
kU
sd
gm
gm
sd
gm
gm
gm
gm
sd
kU
kU
yi
ad
du
aQ
aa
aa
"}
(15,1,1) = {"
du
ad
BI
ad
ad
aF
aF
Hf
kU
gm
gm
gm
kU
gm
gm
gm
cs
gm
gm
gm
yi
ad
bu
aQ
aa
aa
"}
(16,1,1) = {"
ad
ah
pA
rX
bA
ar
bf
Hf
gm
gm
gm
gm
kU
gm
gm
gm
gm
gm
gm
kU
yi
ad
bu
aa
aa
aa
"}
(17,1,1) = {"
aw
ai
Mh
bz
as
aO
bg
Hf
gm
gm
gm
gm
yi
yi
yi
kU
kU
sd
kU
kU
yi
ad
bu
aa
aa
aa
"}
(18,1,1) = {"
ad
Ty
rw
au
aL
aP
xO
Hf
kU
gm
gm
Rj
yi
yi
yi
gm
gm
gm
gm
kU
cj
ad
bu
aa
aa
aa
"}
(19,1,1) = {"
aI
ai
BA
as
bB
ba
bg
Hf
kU
sd
kU
kU
yi
yi
yi
gm
gm
gm
gm
gm
yi
ad
bu
aa
aa
aa
"}
(20,1,1) = {"
ad
ak
CU
ch
aG
aG
bh
Hf
kU
gm
gm
gm
gm
gm
kU
Em
gm
gm
gm
gm
yi
ad
bu
aQ
aa
aa
"}
(21,1,1) = {"
du
ad
uA
ad
ad
aF
aF
Hf
kU
gm
gm
gm
mP
gm
kU
gm
gm
gm
gm
gm
yi
ad
bu
aQ
aa
aa
"}
(22,1,1) = {"
bx
bK
xD
ci
WS
bg
ME
Hf
kU
sd
gm
gm
gm
gm
sd
gm
gm
sd
kU
kU
yi
ad
du
aQ
aa
aa
"}
(23,1,1) = {"
ac
ac
ls
ac
ai
bg
ME
gm
gm
kU
sv
yi
gm
sv
kU
yi
sv
kU
gm
kU
cj
ad
bu
aQ
aa
aa
"}
(24,1,1) = {"
ac
ac
ge
bF
Zr
wO
MT
yN
yN
yN
Aa
yN
yN
Aa
yN
yN
oM
kU
gm
kU
yi
ad
bu
aa
aa
aa
"}
(25,1,1) = {"
ae
cd
an
Jf
ak
AE
ad
gm
gm
kU
CI
CI
CI
CI
CI
CI
CI
kU
gm
yi
qG
ad
bu
aa
aa
aa
"}
(26,1,1) = {"
ac
ac
an
bL
du
ad
ad
ad
wH
yi
yi
yi
yi
bQ
yi
yi
yi
yi
yi
yi
ad
ad
bu
aa
aa
aa
"}
(27,1,1) = {"
ab
Mi
wN
Mi
Jk
gc
kd
zz
in
HU
bm
cI
oD
VT
SH
Rw
bW
HU
yi
yi
xH
aR
aa
aa
aa
aa
"}
(28,1,1) = {"
ab
ck
an
aE
bb
mQ
bT
ad
On
uo
jA
CQ
ad
ad
ad
On
jA
CQ
aq
aq
ad
aQ
aa
aa
aa
aa
"}
(29,1,1) = {"
ab
av
GW
bb
bb
bb
ad
ad
ad
ad
ad
ad
ad
du
ad
ad
ad
ad
aU
ad
WN
aQ
aQ
aQ
aa
aa
"}
