//MAP CONVERTED BY dmm2tgm.py THIS HEADER COMMENT PREVENTS RECONVERSION, DO NOT REMOVE
"a" = (
/turf/template_noop,
/area/template_noop)
"c" = (
/turf/closed/mineral/random/high_chance,
/area/ruins/space/no_gravity/unpowered/generic)
"d" = (
/turf/closed/mineral,
/area/ruins/space/no_gravity/unpowered/generic)
"e" = (
/turf/open/floor/plating/asteroid/airless,
/area/ruins/space/no_gravity/unpowered/generic)
"g" = (
/turf/closed/mineral/bananium,
/area/ruins/space/no_gravity/unpowered/generic)
"i" = (
/turf/open/floor/plating/asteroid,
/area/ruins/space/no_gravity/unpowered/generic)
"j" = (
/turf/closed/wall/mineral/titanium,
/area/ruins/space/unpowered/generic)
"k" = (
/obj/structure/chair{
	dir = 1
	},
/obj/item/shard,
/obj/effect/mob_spawn/human/clown{
	brute_damage = 120;
	oxy_damage = 75
	},
/obj/item/paper/fluff/ruins/asteroid4/extraction,
/obj/item/stack/sheet/mineral/bananium{
	amount = 15
	},
/turf/open/floor/mineral/titanium/blue,
/area/ruins/space/unpowered/generic)
"l" = (
/obj/structure/chair{
	dir = 1
	},
/obj/item/storage/pod{
	pixel_x = -26
	},
/obj/item/stack/sheet/mineral/bananium{
	amount = 15
	},
/turf/open/floor/mineral/titanium/blue,
/area/ruins/space/unpowered/generic)
"o" = (
/obj/structure/shuttle/engine/propulsion/burst,
/turf/closed/wall/mineral/titanium/overspace,
/area/ruins/space/unpowered/generic)
"p" = (
/obj/machinery/door/airlock/titanium{
	name = "Escape Pod Airlock"
	},
/turf/open/floor/mineral/titanium/blue,
/area/ruins/space/unpowered/generic)

(1,1,1) = {"
a
c
c
d
d
a
a
a
a
a
a
a
a
a
d
d
a
a
"}
(2,1,1) = {"
d
c
c
d
e
e
a
a
a
a
a
a
d
d
d
d
a
a
"}
(3,1,1) = {"
d
c
c
d
e
e
e
a
a
a
d
d
d
d
d
a
a
d
"}
(4,1,1) = {"
d
d
d
d
d
e
e
a
a
a
a
a
d
d
d
a
a
a
"}
(5,1,1) = {"
a
d
d
d
d
d
e
e
a
a
a
a
a
a
a
a
d
a
"}
(6,1,1) = {"
a
d
c
d
d
d
e
e
a
a
a
a
a
a
a
a
a
a
"}
(7,1,1) = {"
a
d
d
d
d
d
e
e
a
a
a
a
a
a
a
a
a
a
"}
(8,1,1) = {"
a
a
d
d
d
d
d
d
a
a
a
a
e
e
e
a
a
a
"}
(9,1,1) = {"
a
a
d
d
d
d
a
a
a
a
a
d
d
e
e
a
a
a
"}
(10,1,1) = {"
a
a
a
d
c
c
a
a
a
a
d
d
d
d
d
d
a
a
"}
(11,1,1) = {"
a
a
a
a
a
a
a
a
a
a
d
d
g
j
j
j
o
a
"}
(12,1,1) = {"
a
a
a
a
a
a
a
a
a
c
c
g
g
j
k
l
p
a
"}
(13,1,1) = {"
a
a
a
a
a
a
a
a
a
c
c
d
i
j
j
j
o
a
"}
(14,1,1) = {"
a
a
a
a
a
a
d
d
d
d
d
d
d
d
d
d
a
a
"}
(15,1,1) = {"
a
a
a
d
d
d
d
d
d
d
a
a
c
c
d
a
a
a
"}
(16,1,1) = {"
a
a
d
d
d
d
d
a
a
a
a
a
a
a
a
a
a
a
"}
(17,1,1) = {"
a
a
a
a
d
a
a
a
a
a
a
a
a
a
a
a
a
a
"}
