//MAP CONVERTED BY dmm2tgm.py THIS HEADER COMMENT PREVENTS RECONVERSION, DO NOT REMOVE
"a" = (
/turf/template_noop,
/area/template_noop)
"b" = (
/obj/structure/lattice,
/turf/template_noop,
/area/space/nearstation)
"c" = (
/turf/open/floor/plating/beach/sand,
/area/ruins/space/powered/generic)
"d" = (
/obj/structure/fans/tiny/invisible,
/turf/open/floor/plating/beach/sand,
/area/ruins/space/powered/generic)
"e" = (
/obj/item/reagent_containers/food/snacks/grown/banana,
/obj/item/reagent_containers/food/snacks/grown/banana,
/obj/item/reagent_containers/food/snacks/grown/banana,
/obj/item/reagent_containers/food/snacks/grown/banana,
/obj/item/reagent_containers/food/snacks/grown/banana,
/obj/structure/fans/tiny/invisible,
/obj/structure/closet/secure_closet/freezer,
/turf/open/floor/plating/beach/sand,
/area/ruins/space/powered/generic)
"f" = (
/obj/structure/chair/sofa/left{
	dir = 4
	},
/turf/open/floor/plating/beach/sand,
/area/ruins/space/powered/generic)
"g" = (
/obj/item/flashlight/lamp/bananalamp{
	light_range = 10
	},
/obj/structure/table/wood,
/obj/structure/fans/tiny/invisible,
/turf/open/floor/plating/beach/sand,
/area/ruins/space/powered/generic)
"h" = (
/obj/structure/table/wood,
/obj/machinery/computer/security/wooden_tv,
/turf/open/floor/plating/beach/sand,
/area/ruins/space/powered/generic)
"i" = (
/obj/structure/chair/sofa/right{
	dir = 4
	},
/turf/open/floor/plating/beach/sand,
/area/ruins/space/powered/generic)
"j" = (
/obj/structure/sink/puddle,
/turf/open/floor/plating/beach/sand,
/area/ruins/space/powered/generic)
"k" = (
/obj/structure/chair/sofa{
	dir = 4
	},
/mob/living/simple_animal/hostile/gorilla{
	AIStatus = null;
	desc = "There is no need to be upset.";
	dir = 4;
	name = "Familiar Gorilla"
	},
/turf/open/floor/plating/beach/sand,
/area/ruins/space/powered/generic)
"l" = (
/obj/effect/overlay/palmtree_r,
/obj/structure/fans/tiny/invisible,
/turf/open/floor/plating/beach/sand,
/area/ruins/space/powered/generic)
"m" = (
/obj/item/grown/bananapeel,
/turf/open/floor/plating/beach/sand,
/area/ruins/space/powered/generic)

(1,1,1) = {"
a
a
a
a
a
a
a
a
b
a
"}
(2,1,1) = {"
a
a
b
b
b
b
b
b
a
a
"}
(3,1,1) = {"
a
a
b
b
g
d
d
b
b
a
"}
(4,1,1) = {"
a
a
b
d
f
k
i
d
d
b
"}
(5,1,1) = {"
a
a
b
e
c
c
m
j
d
b
"}
(6,1,1) = {"
a
a
b
d
c
h
c
l
d
b
"}
(7,1,1) = {"
a
b
b
b
d
d
d
b
b
a
"}
(8,1,1) = {"
a
b
a
a
b
b
b
b
b
b
"}
(9,1,1) = {"
a
b
a
a
a
b
a
a
a
b
"}
(10,1,1) = {"
a
a
a
a
a
b
a
a
a
a
"}
