//MAP CONVERTED BY dmm2tgm.py THIS HEADER COMMENT PREVENTS RECONVERSION, DO NOT REMOVE
"a" = (
/turf/template_noop,
/area/template_noop)
"b" = (
/turf/closed/wall/r_wall,
/area/ruins/space/powered/cloning_facility)
"c" = (
/obj/effect/spawner/structure/window/reinforced,
/turf/open/floor/plating/airless,
/area/ruins/space/powered/cloning_facility)
"e" = (
/obj/effect/decal/cleanable/vomit/old,
/obj/effect/turf_decal/tile/blue{
	dir = 1
	},
/obj/effect/turf_decal/tile/blue,
/obj/effect/turf_decal/tile/blue{
	dir = 4
	},
/obj/effect/turf_decal/tile/blue{
	dir = 8
	},
/obj/machinery/defibrillator_mount/loaded{
	pixel_y = 32
	},
/turf/open/floor/plasteel/white,
/area/ruins/space/powered/cloning_facility)
"f" = (
/obj/machinery/door/airlock/research/glass,
/obj/effect/turf_decal/stripes/line{
	dir = 1
	},
/obj/effect/turf_decal/stripes/line,
/obj/effect/mapping_helpers/airlock/cyclelink_helper{
	dir = 4
	},
/turf/open/floor/plasteel,
/area/ruins/space/powered/cloning_facility)
"g" = (
/obj/structure/table,
/obj/item/flashlight/lamp,
/obj/effect/decal/cleanable/cobweb,
/obj/effect/turf_decal/tile/blue{
	dir = 1
	},
/obj/effect/turf_decal/tile/blue,
/obj/effect/turf_decal/tile/blue{
	dir = 4
	},
/obj/effect/turf_decal/tile/blue{
	dir = 8
	},
/turf/open/floor/plasteel/white,
/area/ruins/space/powered/cloning_facility)
"h" = (
/obj/structure/table,
/obj/item/pen,
/obj/item/paper/fluff/ruins/exp_cloning/log,
/obj/effect/turf_decal/tile/blue{
	dir = 1
	},
/obj/effect/turf_decal/tile/blue,
/obj/effect/turf_decal/tile/blue{
	dir = 4
	},
/obj/effect/turf_decal/tile/blue{
	dir = 8
	},
/turf/open/floor/plasteel/white,
/area/ruins/space/powered/cloning_facility)
"i" = (
/obj/machinery/dna_scannernew,
/obj/effect/turf_decal/tile/blue{
	dir = 1
	},
/obj/effect/turf_decal/tile/blue,
/obj/effect/turf_decal/tile/blue{
	dir = 4
	},
/obj/effect/turf_decal/tile/blue{
	dir = 8
	},
/turf/open/floor/plasteel/white,
/area/ruins/space/powered/cloning_facility)
"j" = (
/obj/machinery/computer/prototype_cloning,
/obj/machinery/light{
	dir = 1
	},
/obj/item/paper/fluff/ruins/exp_cloning/manual,
/obj/effect/turf_decal/tile/blue{
	dir = 1
	},
/obj/effect/turf_decal/tile/blue,
/obj/effect/turf_decal/tile/blue{
	dir = 4
	},
/obj/effect/turf_decal/tile/blue{
	dir = 8
	},
/turf/open/floor/plasteel/white,
/area/ruins/space/powered/cloning_facility)
"k" = (
/obj/machinery/clonepod/experimental,
/obj/effect/turf_decal/tile/blue{
	dir = 1
	},
/obj/effect/turf_decal/tile/blue,
/obj/effect/turf_decal/tile/blue{
	dir = 4
	},
/obj/effect/turf_decal/tile/blue{
	dir = 8
	},
/turf/open/floor/plasteel/white,
/area/ruins/space/powered/cloning_facility)
"l" = (
/obj/machinery/door/airlock/research/glass,
/obj/effect/turf_decal/stripes/line,
/obj/effect/turf_decal/stripes/line{
	dir = 1
	},
/obj/effect/mapping_helpers/airlock/cyclelink_helper{
	dir = 8
	},
/turf/open/floor/plasteel,
/area/ruins/space/powered/cloning_facility)
"m" = (
/obj/effect/decal/cleanable/cobweb/cobweb2,
/obj/effect/turf_decal/tile/blue{
	dir = 1
	},
/obj/effect/turf_decal/tile/blue,
/obj/effect/turf_decal/tile/blue{
	dir = 4
	},
/obj/effect/turf_decal/tile/blue{
	dir = 8
	},
/turf/open/floor/plasteel/white,
/area/ruins/space/powered/cloning_facility)
"n" = (
/obj/structure/sign/nanotrasen,
/turf/closed/wall,
/area/ruins/space/powered/cloning_facility)
"o" = (
/obj/machinery/vending/snack/teal,
/obj/effect/decal/cleanable/dirt,
/turf/open/floor/plasteel/airless,
/area/ruins/space/powered/cloning_facility)
"p" = (
/obj/effect/decal/cleanable/dirt,
/turf/open/floor/plasteel/airless,
/area/ruins/space/powered/cloning_facility)
"q" = (
/obj/structure/sign/directions/science{
	dir = 8
	},
/turf/closed/wall/r_wall,
/area/ruins/space/powered/cloning_facility)
"r" = (
/obj/effect/decal/remains/human,
/obj/effect/decal/cleanable/blood/old,
/turf/open/floor/plasteel,
/area/ruins/space/powered/cloning_facility)
"s" = (
/obj/machinery/iv_drip,
/turf/open/floor/plasteel,
/area/ruins/space/powered/cloning_facility)
"t" = (
/obj/machinery/light{
	dir = 4
	},
/obj/structure/bed,
/obj/item/bedsheet/medical,
/turf/open/floor/plasteel,
/area/ruins/space/powered/cloning_facility)
"u" = (
/obj/machinery/light{
	dir = 8
	},
/obj/effect/turf_decal/stripes/line{
	dir = 8
	},
/turf/open/floor/plasteel/white,
/area/ruins/space/powered/cloning_facility)
"v" = (
/obj/effect/turf_decal/tile/blue{
	dir = 4
	},
/turf/open/floor/plasteel/white,
/area/ruins/space/powered/cloning_facility)
"w" = (
/obj/structure/chair/office{
	dir = 1
	},
/obj/effect/turf_decal/tile/blue{
	dir = 1
	},
/obj/effect/turf_decal/tile/blue{
	dir = 4
	},
/turf/open/floor/plasteel/white,
/area/ruins/space/powered/cloning_facility)
"x" = (
/obj/effect/turf_decal/tile/blue{
	dir = 1
	},
/obj/effect/turf_decal/tile/blue{
	dir = 4
	},
/turf/open/floor/plasteel/white,
/area/ruins/space/powered/cloning_facility)
"y" = (
/obj/structure/chair/office{
	dir = 1
	},
/obj/effect/turf_decal/tile/blue{
	dir = 1
	},
/obj/effect/turf_decal/tile/blue,
/obj/effect/turf_decal/tile/blue{
	dir = 4
	},
/obj/effect/turf_decal/tile/blue{
	dir = 8
	},
/turf/open/floor/plasteel/white,
/area/ruins/space/powered/cloning_facility)
"z" = (
/obj/machinery/light{
	dir = 4
	},
/obj/effect/turf_decal/tile/blue{
	dir = 1
	},
/turf/open/floor/plasteel/white,
/area/ruins/space/powered/cloning_facility)
"A" = (
/obj/structure/sign/departments/science,
/turf/closed/wall,
/area/ruins/space/powered/cloning_facility)
"B" = (
/turf/open/floor/plasteel/airless,
/area/ruins/space/powered/cloning_facility)
"C" = (
/turf/open/floor/plating/airless,
/area/ruins/space/powered/cloning_facility)
"D" = (
/obj/structure/chair/comfy{
	dir = 8
	},
/turf/open/floor/plasteel,
/area/ruins/space/powered/cloning_facility)
"E" = (
/turf/open/floor/plasteel,
/area/ruins/space/powered/cloning_facility)
"G" = (
/obj/effect/turf_decal/stripes/line{
	dir = 1
	},
/obj/effect/turf_decal/stripes/line,
/turf/open/floor/plasteel,
/area/ruins/space/powered/cloning_facility)
"I" = (
/obj/effect/turf_decal/stripes/line{
	dir = 8
	},
/turf/open/floor/plasteel/white,
/area/ruins/space/powered/cloning_facility)
"J" = (
/turf/open/floor/plasteel/white,
/area/ruins/space/powered/cloning_facility)
"K" = (
/obj/machinery/door/airlock/research/glass,
/turf/open/floor/plasteel/airless,
/area/ruins/space/powered/cloning_facility)
"L" = (
/turf/open/floor/plating/airless{
	icon_state = "platingdmg1"
	},
/area/ruins/space/powered/cloning_facility)
"M" = (
/obj/structure/fluff/broken_flooring{
	dir = 8;
	icon_state = "plating";
	name = "broken plating"
	},
/turf/template_noop,
/area/space/nearstation)
"N" = (
/obj/item/book/random/triple,
/turf/open/floor/plasteel,
/area/ruins/space/powered/cloning_facility)
"O" = (
/obj/machinery/light{
	dir = 4
	},
/obj/structure/bookcase/random/fiction,
/turf/open/floor/plasteel,
/area/ruins/space/powered/cloning_facility)
"P" = (
/obj/structure/table/glass,
/obj/machinery/light,
/obj/structure/bedsheetbin,
/turf/open/floor/plasteel/white,
/area/ruins/space/powered/cloning_facility)
"Q" = (
/obj/structure/table/glass,
/turf/open/floor/plasteel/white,
/area/ruins/space/powered/cloning_facility)
"R" = (
/obj/structure/table/glass,
/obj/item/storage/firstaid/regular,
/obj/item/healthanalyzer{
	desc = "A prototype hand-held body scanner able to distinguish vital signs of the subject.";
	name = "prototype health analyzer"
	},
/turf/open/floor/plasteel/white,
/area/ruins/space/powered/cloning_facility)
"S" = (
/obj/structure/table/glass,
/obj/item/storage/box/syringes,
/turf/open/floor/plasteel/white,
/area/ruins/space/powered/cloning_facility)
"T" = (
/turf/closed/wall,
/area/ruins/space/powered/cloning_facility)
"U" = (
/turf/open/floor/plating/airless{
	icon_state = "platingdmg2"
	},
/area/ruins/space/powered/cloning_facility)
"V" = (
/turf/closed/wall/r_wall/rust,
/area/ruins/space/powered/cloning_facility)

(1,1,1) = {"
a
a
a
a
a
a
a
a
a
"}
(2,1,1) = {"
a
a
a
a
a
a
a
a
a
"}
(3,1,1) = {"
a
a
c
c
c
c
c
a
a
"}
(4,1,1) = {"
a
a
c
r
D
N
c
a
a
"}
(5,1,1) = {"
a
a
c
s
E
E
c
a
a
"}
(6,1,1) = {"
a
a
V
t
E
O
V
a
a
"}
(7,1,1) = {"
a
a
V
b
f
V
V
a
a
"}
(8,1,1) = {"
a
a
a
b
G
b
a
a
a
"}
(9,1,1) = {"
a
a
V
V
l
b
b
a
a
"}
(10,1,1) = {"
a
b
b
u
I
I
c
a
a
"}
(11,1,1) = {"
a
c
g
v
J
J
c
a
a
"}
(12,1,1) = {"
a
c
h
w
J
J
V
a
a
"}
(13,1,1) = {"
a
V
i
x
J
P
b
a
a
"}
(14,1,1) = {"
a
b
j
y
J
Q
c
a
a
"}
(15,1,1) = {"
a
b
k
x
J
R
c
a
a
"}
(16,1,1) = {"
a
b
e
x
J
S
V
a
a
"}
(17,1,1) = {"
a
V
m
z
J
J
V
a
a
"}
(18,1,1) = {"
a
V
n
A
K
T
b
a
a
"}
(19,1,1) = {"
a
c
o
B
p
C
V
a
a
"}
(20,1,1) = {"
a
c
p
p
C
U
M
a
a
"}
(21,1,1) = {"
a
V
q
C
L
M
a
a
a
"}
(22,1,1) = {"
a
a
b
c
M
a
a
a
a
"}
(23,1,1) = {"
a
a
a
a
a
a
a
a
a
"}
