//MAP CONVERTED BY dmm2tgm.py THIS HEADER COMMENT PREVENTS RECONVERSION, DO NOT REMOVE
"aa" = (
/turf/closed/wall/mineral/titanium,
/area/ruins/space/powered/generic)
"ab" = (
/mob/living/simple_animal/hostile/retaliate/goat/guard,
/turf/open/floor/mineral/titanium,
/area/ruins/space/powered/generic)
"ac" = (
/mob/living/simple_animal/hostile/retaliate/goat/guard/master,
/turf/open/floor/mineral/titanium/blue,
/area/ruins/space/powered/generic)
"ad" = (
/obj/structure/shuttle/engine/heater{
	dir = 8
	},
/turf/open/floor/plating/airless,
/area/ruins/space/powered/generic)
"ae" = (
/obj/machinery/light,
/turf/open/floor/grass,
/area/ruins/space/powered/generic)
"af" = (
/obj/structure/sink/puddle,
/turf/open/floor/grass,
/area/ruins/space/powered/generic)
"ag" = (
/obj/effect/spawner/structure/window/reinforced/indestructable,
/turf/open/floor/plating,
/area/ruins/space/powered/generic)
"ah" = (
/mob/living/simple_animal/hostile/retaliate/goat/paper,
/turf/open/floor/grass,
/area/ruins/space/powered/generic)
"ai" = (
/obj/machinery/light,
/mob/living/simple_animal/hostile/retaliate/goat/guard,
/turf/open/floor/mineral/titanium,
/area/ruins/space/powered/generic)
"aj" = (
/obj/structure/closet/radiation,
/turf/open/floor/mineral/titanium,
/area/ruins/space/powered/generic)
"ak" = (
/turf/open/floor/mineral/titanium,
/area/ruins/space/powered/generic)
"al" = (
/obj/structure/table/wood/poker,
/turf/open/floor/mineral/titanium,
/area/ruins/space/powered/generic)
"am" = (
/obj/effect/mob_spawn/human/corpse/damaged,
/obj/effect/decal/cleanable/blood/old,
/turf/open/floor/mineral/titanium/white,
/area/ruins/space/powered/generic)
"an" = (
/mob/living/simple_animal/hostile/retaliate/goat/guard,
/turf/open/floor/mineral/titanium/blue,
/area/ruins/space/powered/generic)
"ao" = (
/obj/structure/table,
/turf/open/floor/mineral/titanium/white,
/area/ruins/space/powered/generic)
"ap" = (
/obj/effect/mob_spawn/human/corpse/nanotrasensoldier,
/obj/effect/decal/cleanable/blood/old,
/obj/item/gun/ballistic/rifle/boltaction,
/turf/open/floor/mineral/titanium,
/area/ruins/space/powered/generic)
"aq" = (
/obj/machinery/atmospherics/components/unary/cryo_cell,
/turf/open/floor/mineral/titanium/white,
/area/ruins/space/powered/generic)
"ar" = (
/obj/machinery/door/airlock/highsecurity{
	name = "Exotic Animal Storage"
	},
/turf/open/floor/mineral/titanium,
/area/ruins/space/powered/generic)
"as" = (
/obj/machinery/light{
	dir = 8
	},
/mob/living/simple_animal/hostile/retaliate/goat/guard,
/turf/open/floor/mineral/titanium,
/area/ruins/space/powered/generic)
"at" = (
/obj/effect/turf_decal/loading_area{
	dir = 8;
	icon_state = "loadingarea"
	},
/obj/machinery/button{
	id = "goatshutters";
	pixel_y = 24
	},
/turf/open/floor/mineral/titanium/yellow,
/area/ruins/space/powered/generic)
"au" = (
/obj/machinery/door/airlock/external/glass,
/turf/open/floor/mineral/titanium/yellow,
/area/ruins/space/powered/generic)
"av" = (
/mob/living/simple_animal/hostile/retaliate/goat/chocolate,
/turf/open/floor/grass,
/area/ruins/space/powered/generic)
"aw" = (
/obj/machinery/door/poddoor/shutters{
	id = "goatshutters"
	},
/turf/open/floor/plating,
/area/ruins/space/powered/generic)
"ax" = (
/obj/machinery/light{
	dir = 4
	},
/turf/open/floor/mineral/titanium,
/area/ruins/space/powered/generic)
"ay" = (
/obj/machinery/atmospherics/pipe/simple/general/visible{
	dir = 5
	},
/turf/open/floor/mineral/titanium/white,
/area/ruins/space/powered/generic)
"az" = (
/turf/open/floor/grass,
/area/ruins/space/powered/generic)
"aA" = (
/obj/machinery/door/airlock/medical/glass,
/turf/open/floor/mineral/titanium/white,
/area/ruins/space/powered/generic)
"aB" = (
/obj/machinery/light,
/turf/open/floor/mineral/titanium,
/area/ruins/space/powered/generic)
"aC" = (
/turf/open/floor/plating/airless,
/area/ruins/space/powered/generic)
"aD" = (
/mob/living/simple_animal/hostile/retaliate/goat/twisted,
/turf/open/floor/grass,
/area/ruins/space/powered/generic)
"aE" = (
/mob/living/simple_animal/hostile/retaliate/goat/legitgoat,
/turf/open/floor/grass,
/area/ruins/space/powered/generic)
"aF" = (
/obj/structure/chair/wood/normal{
	dir = 1;
	icon_state = "wooden_chair"
	},
/turf/open/floor/mineral/titanium,
/area/ruins/space/powered/generic)
"aG" = (
/obj/effect/turf_decal/loading_area{
	dir = 8;
	icon_state = "loadingarea"
	},
/turf/open/floor/mineral/titanium/yellow,
/area/ruins/space/powered/generic)
"aH" = (
/obj/effect/turf_decal/delivery,
/turf/open/floor/mineral/titanium/yellow,
/area/ruins/space/powered/generic)
"aI" = (
/obj/machinery/door/airlock/vault{
	name = "Dangerous Exotic Animal"
	},
/turf/open/floor/mineral/titanium,
/area/ruins/space/powered/generic)
"aJ" = (
/obj/structure/chair/sofa{
	dir = 4;
	icon_state = "sofamiddle"
	},
/turf/open/floor/mineral/titanium,
/area/ruins/space/powered/generic)
"aK" = (
/obj/machinery/vending/cola/random,
/turf/open/floor/mineral/titanium,
/area/ruins/space/powered/generic)
"aL" = (
/turf/open/floor/mineral/titanium/white,
/area/ruins/space/powered/generic)
"aM" = (
/obj/structure/showcase/machinery/tv,
/obj/structure/table/wood,
/obj/machinery/light{
	dir = 4
	},
/turf/open/floor/mineral/titanium,
/area/ruins/space/powered/generic)
"aN" = (
/obj/structure/table/wood/poker,
/obj/item/toy/cards/deck,
/turf/open/floor/mineral/titanium,
/area/ruins/space/powered/generic)
"aO" = (
/obj/effect/turf_decal/delivery,
/obj/structure/closet/crate/hydroponics,
/turf/open/floor/mineral/titanium/yellow,
/area/ruins/space/powered/generic)
"aP" = (
/obj/machinery/light{
	dir = 1
	},
/mob/living/simple_animal/hostile/retaliate/goat/guard,
/turf/open/floor/mineral/titanium/blue,
/area/ruins/space/powered/generic)
"aQ" = (
/obj/item/wrench/medical,
/obj/machinery/atmospherics/pipe/simple/general/visible{
	dir = 9
	},
/turf/open/floor/mineral/titanium/white,
/area/ruins/space/powered/generic)
"aR" = (
/mob/living/simple_animal/hostile/retaliate/goat/star,
/turf/open/floor/grass,
/area/ruins/space/powered/generic)
"aS" = (
/obj/structure/table/wood/poker,
/obj/item/toy/cards/cardhand,
/turf/open/floor/mineral/titanium,
/area/ruins/space/powered/generic)
"aT" = (
/obj/effect/turf_decal/delivery,
/obj/structure/closet/crate/critter,
/turf/open/floor/mineral/titanium/yellow,
/area/ruins/space/powered/generic)
"aU" = (
/obj/machinery/atmospherics/components/unary/portables_connector/visible,
/obj/machinery/portable_atmospherics/canister/oxygen,
/turf/open/floor/mineral/titanium/white,
/area/ruins/space/powered/generic)
"aV" = (
/obj/machinery/light{
	dir = 1
	},
/turf/open/floor/mineral/titanium,
/area/ruins/space/powered/generic)
"aW" = (
/obj/effect/mob_spawn/human/corpse/cargo_tech,
/obj/effect/decal/cleanable/blood/old,
/turf/open/floor/mineral/titanium,
/area/ruins/space/powered/generic)
"aX" = (
/mob/living/simple_animal/hostile/retaliate/goat/glowing,
/turf/open/floor/grass,
/area/ruins/space/powered/generic)
"aY" = (
/obj/structure/chair/sofa/left{
	dir = 4;
	icon_state = "sofaend_left"
	},
/turf/open/floor/mineral/titanium,
/area/ruins/space/powered/generic)
"aZ" = (
/obj/structure/chair/wood/normal{
	dir = 1;
	icon_state = "wooden_chair"
	},
/mob/living/simple_animal/hostile/retaliate/goat/guard,
/turf/open/floor/mineral/titanium,
/area/ruins/space/powered/generic)
"ba" = (
/obj/machinery/light{
	dir = 1
	},
/turf/open/floor/grass,
/area/ruins/space/powered/generic)
"bb" = (
/obj/structure/sign/warning/vacuum{
	pixel_x = 32
	},
/mob/living/simple_animal/hostile/retaliate/goat/guard,
/turf/open/floor/mineral/titanium,
/area/ruins/space/powered/generic)
"bc" = (
/obj/machinery/light,
/mob/living/simple_animal/hostile/retaliate/goat/guard,
/turf/open/floor/mineral/titanium/blue,
/area/ruins/space/powered/generic)
"bd" = (
/obj/effect/decal/cleanable/blood/old,
/obj/effect/mob_spawn/human/doctor,
/turf/open/floor/mineral/titanium/white,
/area/ruins/space/powered/generic)
"be" = (
/obj/machinery/light{
	dir = 8
	},
/mob/living/simple_animal/hostile/retaliate/goat/guard,
/turf/open/floor/mineral/titanium/white,
/area/ruins/space/powered/generic)
"bf" = (
/obj/structure/chair/wood/normal,
/turf/open/floor/mineral/titanium,
/area/ruins/space/powered/generic)
"bg" = (
/turf/closed/wall/mineral/titanium/nodiagonal,
/area/ruins/space/powered/generic)
"bh" = (
/mob/living/simple_animal/hostile/retaliate/goat/horror,
/turf/open/floor/grass,
/area/ruins/space/powered/generic)
"bi" = (
/obj/machinery/atmospherics/components/unary/thermomachine/freezer,
/turf/open/floor/mineral/titanium/white,
/area/ruins/space/powered/generic)
"bj" = (
/obj/structure/chair/wood/normal{
	dir = 8;
	icon_state = "wooden_chair"
	},
/turf/open/floor/mineral/titanium,
/area/ruins/space/powered/generic)
"bk" = (
/obj/structure/table/reinforced,
/obj/machinery/door/window/westleft,
/obj/machinery/door/window/eastleft,
/turf/open/floor/mineral/titanium/white,
/area/ruins/space/powered/generic)
"bl" = (
/obj/machinery/light{
	dir = 4
	},
/turf/open/floor/mineral/titanium/blue,
/area/ruins/space/powered/generic)
"bm" = (
/mob/living/simple_animal/hostile/retaliate/goat/pixel,
/turf/open/floor/grass,
/area/ruins/space/powered/generic)
"bn" = (
/turf/closed/wall/mineral/plastitanium/explosive,
/area/ruins/space/powered/generic)
"bo" = (
/obj/machinery/atmospherics/pipe/manifold/general/visible,
/turf/open/floor/mineral/titanium/white,
/area/ruins/space/powered/generic)
"bp" = (
/obj/effect/turf_decal/delivery,
/obj/structure/closet/crate/internals,
/turf/open/floor/mineral/titanium/yellow,
/area/ruins/space/powered/generic)
"bq" = (
/obj/machinery/light{
	dir = 8
	},
/turf/open/floor/mineral/titanium,
/area/ruins/space/powered/generic)
"br" = (
/obj/machinery/door/airlock/vault,
/turf/open/floor/mineral/titanium,
/area/ruins/space/powered/generic)
"bs" = (
/obj/machinery/vending/snack/random,
/turf/open/floor/mineral/titanium,
/area/ruins/space/powered/generic)
"bt" = (
/obj/machinery/door/airlock/command,
/turf/open/floor/mineral/titanium,
/area/ruins/space/powered/generic)
"bu" = (
/obj/machinery/chem_heater,
/turf/open/floor/mineral/titanium/white,
/area/ruins/space/powered/generic)
"bv" = (
/obj/structure/shuttle/engine/huge{
	dir = 4;
	icon_state = "huge_engine"
	},
/turf/open/floor/plating/airless,
/area/ruins/space/powered/generic)
"bw" = (
/obj/structure/fence/door,
/turf/open/floor/mineral/titanium,
/area/ruins/space/powered/generic)
"bx" = (
/obj/structure/sign/departments/chemistry{
	pixel_y = 32
	},
/turf/open/floor/mineral/titanium/white,
/area/ruins/space/powered/generic)
"by" = (
/obj/structure/chair/wood/normal{
	dir = 1;
	icon_state = "wooden_chair"
	},
/obj/effect/mob_spawn/human/corpse/cargo_tech,
/obj/effect/decal/cleanable/blood/old,
/turf/open/floor/mineral/titanium,
/area/ruins/space/powered/generic)
"bA" = (
/obj/structure/chair/wood/normal,
/obj/effect/mob_spawn/human/corpse/cargo_tech,
/obj/effect/decal/cleanable/blood/old,
/turf/open/floor/mineral/titanium,
/area/ruins/space/powered/generic)
"bB" = (
/obj/machinery/door/airlock/medical/glass,
/obj/effect/decal/cleanable/blood/tracks,
/turf/open/floor/mineral/titanium,
/area/ruins/space/powered/generic)
"bC" = (
/obj/structure/closet/crate{
	icon_state = "crateopen"
	},
/obj/item/reagent_containers/food/snacks/monkeycube/goat,
/obj/item/reagent_containers/food/snacks/monkeycube/goat,
/obj/item/extinguisher,
/turf/open/floor/mineral/titanium,
/area/ruins/space/powered/generic)
"bD" = (
/obj/machinery/chem_dispenser,
/turf/open/floor/mineral/titanium/white,
/area/ruins/space/powered/generic)
"bE" = (
/obj/structure/chair/sofa/right{
	dir = 4;
	icon_state = "sofaend_right"
	},
/turf/open/floor/mineral/titanium,
/area/ruins/space/powered/generic)
"bF" = (
/obj/effect/decal/cleanable/blood/old,
/obj/effect/decal/remains/human,
/obj/machinery/light/broken{
	dir = 1;
	icon_state = "tube-broken"
	},
/turf/open/floor/grass,
/area/ruins/space/powered/generic)
"bG" = (
/obj/structure/fence{
	dir = 4;
	icon_state = "straight"
	},
/turf/open/floor/mineral/titanium,
/area/ruins/space/powered/generic)
"bH" = (
/mob/living/simple_animal/hostile/retaliate/goat/guard,
/turf/open/floor/mineral/titanium/white,
/area/ruins/space/powered/generic)
"bI" = (
/obj/effect/turf_decal/delivery,
/obj/structure/closet/crate/critter/exoticgoats,
/turf/open/floor/mineral/titanium/yellow,
/area/ruins/space/powered/generic)
"bJ" = (
/obj/structure/fence{
	dir = 8;
	icon_state = "straight"
	},
/turf/open/floor/mineral/titanium,
/area/ruins/space/powered/generic)
"bK" = (
/mob/living/simple_animal/hostile/retaliate/goat/ras,
/turf/open/floor/grass,
/area/ruins/space/powered/generic)
"bL" = (
/obj/structure/table,
/obj/item/storage/firstaid/regular,
/obj/item/storage/firstaid/regular,
/obj/item/storage/firstaid/regular,
/obj/machinery/light,
/turf/open/floor/mineral/titanium/white,
/area/ruins/space/powered/generic)
"bM" = (
/mob/living/simple_animal/hostile/retaliate/goat/panda,
/turf/open/floor/grass,
/area/ruins/space/powered/generic)
"bN" = (
/obj/machinery/light{
	dir = 1
	},
/obj/structure/sign/departments/medbay/alt{
	pixel_y = 32
	},
/turf/open/floor/mineral/titanium,
/area/ruins/space/powered/generic)
"bO" = (
/mob/living/simple_animal/hostile/retaliate/goat/radioactive,
/turf/open/floor/grass,
/area/ruins/space/powered/generic)
"bP" = (
/obj/structure/table,
/obj/item/reagent_containers/glass/beaker/cryoxadone,
/obj/item/reagent_containers/glass/beaker/cryoxadone,
/obj/item/reagent_containers/glass/beaker/cryoxadone,
/obj/item/reagent_containers/glass/beaker/cryoxadone,
/turf/open/floor/mineral/titanium/white,
/area/ruins/space/powered/generic)
"bQ" = (
/obj/machinery/door/airlock/external,
/obj/structure/fans/tiny,
/turf/open/floor/mineral/titanium/yellow,
/area/ruins/space/powered/generic)
"bR" = (
/obj/structure/chair/wood/normal{
	dir = 4;
	icon_state = "wooden_chair"
	},
/turf/open/floor/mineral/titanium,
/area/ruins/space/powered/generic)
"bS" = (
/obj/machinery/door/airlock/public/glass{
	name = "Common Room"
	},
/turf/open/floor/mineral/titanium,
/area/ruins/space/powered/generic)
"bT" = (
/obj/effect/mob_spawn/human/commander{
	assignedrole = "null";
	mob_gender = "male";
	mob_name = "John Lamario";
	name = "John Lamario"
	},
/obj/effect/decal/cleanable/blood/old,
/obj/item/gun/ballistic/automatic/laser,
/obj/item/paper/crumpled/bloody/goattransport,
/turf/open/floor/mineral/titanium/blue,
/area/ruins/space/powered/generic)
"bU" = (
/obj/effect/turf_decal/delivery,
/mob/living/simple_animal/hostile/retaliate/goat/guard,
/turf/open/floor/mineral/titanium/yellow,
/area/ruins/space/powered/generic)
"bV" = (
/obj/structure/chair/wood/normal{
	dir = 4;
	icon_state = "wooden_chair"
	},
/mob/living/simple_animal/hostile/retaliate/goat/guard,
/turf/open/floor/mineral/titanium,
/area/ruins/space/powered/generic)
"bW" = (
/obj/effect/spawner/structure/window/reinforced,
/turf/open/floor/plating,
/area/ruins/space/powered/generic)
"bX" = (
/obj/structure/table,
/turf/open/floor/mineral/titanium/blue,
/area/ruins/space/powered/generic)
"bY" = (
/mob/living/simple_animal/hostile/retaliate/goat/cottoncandy,
/turf/open/floor/grass,
/area/ruins/space/powered/generic)
"bZ" = (
/obj/effect/decal/cleanable/blood/tracks,
/turf/open/floor/mineral/titanium/white,
/area/ruins/space/powered/generic)
"ca" = (
/obj/effect/turf_decal/delivery,
/obj/effect/mob_spawn/human/corpse/cargo_tech,
/obj/effect/decal/cleanable/blood/old,
/turf/open/floor/mineral/titanium/yellow,
/area/ruins/space/powered/generic)
"cb" = (
/turf/template_noop,
/area/template_noop)
"cc" = (
/mob/living/simple_animal/hostile/retaliate/goat/mirrored,
/turf/open/floor/grass,
/area/ruins/space/powered/generic)
"cd" = (
/obj/machinery/sleeper{
	dir = 8;
	icon_state = "sleeper"
	},
/turf/open/floor/mineral/titanium/white,
/area/ruins/space/powered/generic)
"ce" = (
/mob/living/simple_animal/hostile/retaliate/goat/tiny,
/turf/open/floor/grass,
/area/ruins/space/powered/generic)
"cf" = (
/obj/effect/turf_decal/delivery,
/obj/structure/closet/crate/large,
/obj/machinery/light{
	dir = 8
	},
/turf/open/floor/mineral/titanium/yellow,
/area/ruins/space/powered/generic)
"cg" = (
/mob/living/simple_animal/hostile/retaliate/goat/rainbow,
/turf/open/floor/grass,
/area/ruins/space/powered/generic)
"ch" = (
/obj/machinery/light{
	dir = 4
	},
/mob/living/simple_animal/hostile/retaliate/goat/guard,
/turf/open/floor/mineral/titanium/blue,
/area/ruins/space/powered/generic)
"ci" = (
/obj/structure/table/reinforced,
/obj/machinery/smartfridge/chemistry,
/turf/open/floor/mineral/titanium/white,
/area/ruins/space/powered/generic)
"cj" = (
/obj/machinery/light,
/turf/open/floor/mineral/titanium/white,
/area/ruins/space/powered/generic)
"ck" = (
/obj/machinery/computer{
	dir = 4;
	icon_state = "computer"
	},
/turf/open/floor/mineral/titanium/blue,
/area/ruins/space/powered/generic)
"cl" = (
/turf/open/floor/mineral/titanium/blue,
/area/ruins/space/powered/generic)
"cm" = (
/obj/structure/closet/crate,
/obj/item/reagent_containers/food/snacks/monkeycube/goat,
/obj/item/reagent_containers/food/snacks/monkeycube/goat,
/obj/item/reagent_containers/food/snacks/monkeycube/goat,
/obj/item/extinguisher,
/turf/open/floor/mineral/titanium,
/area/ruins/space/powered/generic)
"sr" = (
/obj/structure/table/wood/poker,
/obj/item/storage/pill_bottle/dice,
/turf/open/floor/mineral/titanium,
/area/ruins/space/powered/generic)
"wK" = (
/mob/living/simple_animal/hostile/retaliate/goat/watercolor,
/turf/open/floor/grass,
/area/ruins/space/powered/generic)
"xo" = (
/obj/effect/turf_decal/delivery,
/obj/structure/closet/crate/sphere,
/obj/machinery/light{
	dir = 8
	},
/turf/open/floor/mineral/titanium/yellow,
/area/ruins/space/powered/generic)
"ZW" = (
/obj/machinery/chem_master,
/obj/machinery/light{
	dir = 4
	},
/turf/open/floor/mineral/titanium/white,
/area/ruins/space/powered/generic)

(1,1,1) = {"
cb
cb
cb
cb
cb
cb
cb
cb
cb
cb
cb
cb
cb
cb
cb
cb
cb
cb
cb
cb
cb
cb
cb
cb
"}
(2,1,1) = {"
cb
cb
cb
cb
cb
cb
cb
cb
cb
cb
ag
ag
ag
ag
cb
cb
cb
cb
cb
cb
cb
cb
cb
cb
"}
(3,1,1) = {"
cb
cb
cb
cb
cb
cb
cb
cb
cb
cb
ag
ck
ck
ag
cb
cb
cb
cb
cb
cb
cb
cb
cb
cb
"}
(4,1,1) = {"
cb
cb
cb
cb
cb
cb
cb
cb
cb
cb
ag
ac
ac
ag
cb
cb
cb
cb
cb
cb
cb
cb
cb
cb
"}
(5,1,1) = {"
cb
cb
cb
cb
cb
cb
cb
cb
cb
ag
ag
bT
cl
ag
ag
cb
cb
cb
cb
cb
cb
cb
cb
cb
"}
(6,1,1) = {"
cb
cb
cb
cb
cb
cb
cb
cb
aa
ag
bX
cl
cl
bX
ag
aa
cb
cb
cb
cb
cb
cb
cb
cb
"}
(7,1,1) = {"
cb
cb
cb
cb
cb
cb
cb
aa
bg
aP
cl
cl
cl
cl
bc
bg
aa
cb
cb
cb
cb
cb
cb
cb
"}
(8,1,1) = {"
cb
cb
cb
cb
cb
cb
aa
aa
cl
cl
cl
cl
cl
cl
cl
cl
aa
aa
cb
cb
cb
cb
cb
cb
"}
(9,1,1) = {"
cb
cb
cb
cb
cb
aa
aa
cl
cl
cl
cl
cl
cl
cl
cl
cl
cl
aa
aa
cb
cb
cb
cb
cb
"}
(10,1,1) = {"
cb
cb
cb
cb
aa
aa
cl
cl
cl
cl
cl
cl
cl
cl
cl
cl
cl
cl
aa
aa
cb
cb
cb
cb
"}
(11,1,1) = {"
cb
cb
cb
aa
aa
cl
cl
cl
cl
cl
cl
cl
cl
cl
cl
cl
cl
cl
cl
aa
aa
cb
cb
cb
"}
(12,1,1) = {"
cb
cb
aa
aa
cl
cl
cl
cl
cl
cl
cl
cl
cl
cl
cl
cl
cl
cl
cl
cl
aa
aa
cb
cb
"}
(13,1,1) = {"
cb
aa
aa
cl
cl
cl
an
cl
cl
cl
cl
cl
cl
cl
cl
cl
cl
cl
an
cl
cl
aa
aa
cb
"}
(14,1,1) = {"
cb
aa
aP
cl
cl
cl
bl
cl
cl
cl
ch
cl
cl
ch
cl
cl
cl
bl
cl
cl
cl
bc
aa
cb
"}
(15,1,1) = {"
cb
aa
aa
aa
aa
aa
aa
aa
aa
aa
aa
bt
bt
aa
aa
aa
aa
aa
aa
aa
aa
aa
aa
cb
"}
(16,1,1) = {"
cb
aa
af
az
az
bG
ak
bq
ab
aa
bq
ak
ak
bq
aa
ak
as
ak
bG
az
az
af
aa
cb
"}
(17,1,1) = {"
cb
aa
ba
bY
az
bw
ak
ak
ak
aa
ak
ak
ak
ak
aa
ak
ak
ak
bw
az
ah
ae
aa
cb
"}
(18,1,1) = {"
cb
aa
az
az
az
bG
ak
ak
ak
aa
ak
ak
ak
ab
aa
ak
ak
ak
bG
az
az
az
aa
cb
"}
(19,1,1) = {"
cb
aa
bW
bW
bW
bG
ak
ak
aW
aa
ak
ak
ak
ak
aa
aW
ak
ak
bJ
bW
bW
bW
aa
cb
"}
(20,1,1) = {"
cb
aa
af
az
az
bG
ak
ak
ak
aa
ak
ak
ak
ap
aa
ak
ak
ak
bJ
az
az
af
aa
cb
"}
(21,1,1) = {"
cb
aa
ba
aE
az
bw
ak
ak
ak
aa
ab
ak
ak
ak
aa
ak
ak
ak
bw
az
aR
ae
aa
cb
"}
(22,1,1) = {"
cb
aa
az
az
az
bG
ab
ak
ak
aa
aV
ak
ak
aB
aa
ak
ak
ak
bJ
az
az
az
aa
cb
"}
(23,1,1) = {"
cb
aa
bW
bW
bW
bG
ak
ak
ak
aa
ak
ak
ak
ak
aa
ak
ak
ak
bJ
bW
bW
bW
aa
cb
"}
(24,1,1) = {"
cb
aa
af
az
az
bG
ak
ak
ak
aa
ak
ak
ak
ak
aa
ak
ak
ak
bJ
az
az
af
aa
cb
"}
(25,1,1) = {"
cb
aa
ba
aX
az
bw
ak
ak
ak
aa
ak
ab
ak
ak
aa
ak
ak
ak
bw
az
wK
ae
aa
cb
"}
(26,1,1) = {"
cb
aa
az
az
az
bG
ak
ak
ak
aa
ak
ak
ak
ak
aa
ak
ak
ak
bJ
az
az
az
aa
cb
"}
(27,1,1) = {"
cb
aa
bW
bW
bW
bG
ak
ak
ab
aa
ak
ak
ak
ak
aa
ab
ak
ak
bJ
bW
bW
bW
aa
cb
"}
(28,1,1) = {"
cb
aa
af
az
az
bG
ak
ak
aB
aa
aV
ak
ak
ai
aa
aV
ak
ak
bJ
az
az
af
aa
cb
"}
(29,1,1) = {"
cb
aa
ba
bm
az
bw
ak
ak
ak
ar
ak
ak
ak
ak
ar
ak
ak
ak
bw
az
bM
ae
aa
cb
"}
(30,1,1) = {"
cb
aa
az
az
az
bG
ak
ak
ak
aa
ak
ak
ak
aB
aa
aV
ak
ak
bJ
az
az
az
aa
cb
"}
(31,1,1) = {"
cb
aa
bW
bW
bW
bG
ak
ab
aB
aa
aV
ak
ak
ak
aa
ak
ak
ak
bJ
bW
bW
bW
aa
cb
"}
(32,1,1) = {"
cb
aa
af
az
az
bG
ak
ak
ak
aa
ab
ak
ak
ak
aa
ak
ak
ak
bJ
az
az
af
aa
cb
"}
(33,1,1) = {"
cb
aa
ba
cc
az
bw
ak
ak
ak
aa
ak
ak
ak
ak
aa
ak
ak
ak
bw
az
aD
ae
aa
cb
"}
(34,1,1) = {"
cb
aa
az
az
az
bG
ak
ak
ak
aa
ak
ak
ak
ak
aa
ak
ak
ak
bJ
az
az
az
aa
cb
"}
(35,1,1) = {"
cb
aa
bW
bW
bW
bG
ak
ak
ak
aa
ak
ak
ab
ak
aa
ak
ak
ab
bJ
bW
bW
bW
aa
cb
"}
(36,1,1) = {"
cb
aa
af
az
az
bG
ab
ak
ak
aa
aV
ak
ak
aB
aa
ak
ak
ak
bJ
az
az
af
aa
cb
"}
(37,1,1) = {"
cb
aa
ba
ce
az
bw
ak
ak
ak
aa
ak
ak
ak
ak
aa
ak
ak
ak
bw
az
cg
ae
aa
cb
"}
(38,1,1) = {"
cb
aa
az
az
az
bG
ak
ak
ak
aa
ak
ak
ak
ab
aa
ak
ak
ak
bJ
az
az
az
aa
cb
"}
(39,1,1) = {"
cb
aa
bW
bW
bW
bG
ak
ak
ab
aa
ak
ak
ak
ak
aa
ak
ak
ak
bJ
bW
bW
bW
aa
cb
"}
(40,1,1) = {"
cb
aa
af
az
az
bG
ak
ak
ak
aa
ap
ab
ak
ak
aa
ak
ak
ak
bJ
az
az
af
aa
cb
"}
(41,1,1) = {"
cb
aa
ba
av
az
bw
ak
aW
ak
aa
ak
ak
ak
ak
aa
ab
ak
ak
bw
az
bK
ae
aa
cb
"}
(42,1,1) = {"
cb
aa
az
az
az
bG
ak
ab
ak
aa
ak
ak
ak
ak
aa
ak
ak
ak
bJ
az
az
az
aa
cb
"}
(43,1,1) = {"
cb
aa
bn
bn
bn
bn
ak
ak
ak
aa
aV
ak
ak
aB
aa
ak
aW
aj
bn
bn
bn
bn
aa
cb
"}
(44,1,1) = {"
cb
aa
af
az
az
bn
ak
ak
ak
aa
ak
ak
ak
ak
aa
ak
ak
ak
bn
az
az
af
aa
cb
"}
(45,1,1) = {"
cb
aa
bF
az
bh
br
ab
ax
bC
aa
ak
ak
ak
ak
aa
cm
ax
ab
aI
az
bO
ae
aa
cb
"}
(46,1,1) = {"
cb
aa
aa
aa
aa
aa
aa
aa
aa
aa
ab
ak
ak
ak
aa
aa
aa
aa
aa
aa
aa
aa
aa
cb
"}
(47,1,1) = {"
cb
aa
aU
ay
aL
be
aL
aL
bP
aa
ak
ak
ak
ak
aa
bs
ak
ak
bq
ak
ak
ak
aa
cb
"}
(48,1,1) = {"
cb
aa
aq
bo
aL
aL
aL
aL
bL
aa
bN
ak
ak
aB
aa
aK
ak
ak
ak
ak
ab
ak
aa
cb
"}
(49,1,1) = {"
cb
aa
aq
bo
aL
aL
aL
bd
bZ
bB
ak
ak
ak
ak
bS
ak
ak
ak
ak
ak
ak
ak
aa
cb
"}
(50,1,1) = {"
cb
aa
aq
bo
bH
aL
aL
aL
cj
aa
aV
ak
ak
ai
aa
ak
ak
bV
bR
bR
ak
ak
aa
cb
"}
(51,1,1) = {"
cb
aa
aq
bo
aL
am
aL
aL
aL
aa
bb
ak
ak
ak
aa
ak
bf
al
aN
al
aF
ak
aa
cb
"}
(52,1,1) = {"
cb
aa
bi
aQ
aL
aL
aL
aL
aL
aa
aa
au
au
aa
aa
ak
bA
aS
al
al
aF
ak
aa
cb
"}
(53,1,1) = {"
cb
aa
ci
bk
aa
aa
aL
bH
aL
aa
cf
aH
aH
xo
aa
aV
bf
al
al
aS
by
aB
aa
cb
"}
(54,1,1) = {"
cb
aa
aL
aL
ao
aa
aL
aL
aL
aa
bp
aH
aH
aT
aa
ak
bf
al
sr
al
aZ
ak
aa
cb
"}
(55,1,1) = {"
cb
aa
bH
aL
ao
aa
bx
aL
cj
aa
aO
ca
aH
bI
aa
ab
ak
bj
bj
bj
ak
ak
aa
cb
"}
(56,1,1) = {"
cb
aa
aL
am
aL
aA
aL
bd
bH
aa
aH
aH
bU
aH
aa
ak
ak
aY
aJ
bE
ak
ak
aa
cb
"}
(57,1,1) = {"
cb
aa
aL
aL
aL
aa
aL
aL
aL
aa
aH
bU
aH
aH
aa
ak
ak
ak
ak
ak
ak
ab
aa
cb
"}
(58,1,1) = {"
cb
aa
bu
ZW
bD
aa
cd
cd
cd
aa
at
aG
aG
aG
aa
ak
ak
ak
aM
ak
ak
ak
aa
cb
"}
(59,1,1) = {"
cb
aa
aa
aa
aa
aa
aa
aa
aa
bg
aw
bQ
bQ
aw
bg
aa
aa
aa
aa
aa
aa
aa
aa
cb
"}
(60,1,1) = {"
cb
aC
aC
bv
cb
cb
cb
aC
aC
bv
cb
cb
cb
cb
ad
ad
bv
cb
cb
cb
aC
aC
bv
cb
"}
(61,1,1) = {"
cb
aC
aC
aC
cb
cb
cb
aC
aC
aC
cb
cb
cb
cb
aC
aC
aC
cb
cb
cb
aC
aC
aC
cb
"}
(62,1,1) = {"
cb
cb
cb
cb
cb
cb
cb
cb
cb
cb
cb
cb
cb
cb
cb
cb
cb
cb
cb
cb
cb
cb
cb
cb
"}
(63,1,1) = {"
cb
cb
cb
cb
cb
cb
cb
cb
cb
cb
cb
cb
cb
cb
cb
cb
cb
cb
cb
cb
cb
cb
cb
cb
"}
(64,1,1) = {"
cb
cb
cb
cb
cb
cb
cb
cb
cb
cb
cb
cb
cb
cb
cb
cb
cb
cb
cb
cb
cb
cb
cb
cb
"}
