//MAP CONVERTED BY dmm2tgm.py THIS HEADER COMMENT PREVENTS RECONVERSION, DO NOT REMOVE
"b" = (
/obj/machinery/door/poddoor/shutters{
	id = "HippieVan"
	},
/obj/structure/fans/tiny,
/turf/open/floor/mineral/titanium/yellow,
/area/ruins/space/powered/generic)
"d" = (
/obj/effect/mob_spawn/human/corpse/damaged,
/obj/effect/decal/cleanable/blood,
/obj/effect/decal/cleanable/blood/gibs/body,
/obj/effect/decal/cleanable/blood/tracks,
/obj/machinery/button/door{
	id = "HippieVan";
	name = "External Shutters";
	pixel_y = 25
	},
/obj/machinery/light/broken{
	dir = 1
	},
/obj/effect/turf_decal/ramp_middle,
/turf/open/floor/mineral/titanium/yellow,
/area/ruins/space/powered/generic)
"e" = (
/turf/closed/wall/mineral/titanium/nodiagonal,
/area/ruins/space/powered/generic)
"g" = (
/obj/structure/chair/comfy{
	dir = 1;
	icon_state = "comfychair";
	tag = ""
	},
/obj/machinery/light/built{
	dir = 8
	},
/turf/open/floor/mineral/titanium/blue,
/area/ruins/space/powered/generic)
"h" = (
/obj/structure/shuttle/engine/propulsion,
/turf/open/floor/plating/airless,
/area/ruins/space/powered/generic)
"j" = (
/obj/item/reagent_containers/glass/bottle,
/turf/open/floor/mineral/titanium/yellow,
/area/ruins/space/powered/generic)
"k" = (
/turf/open/floor/mineral/titanium/yellow,
/area/ruins/space/powered/generic)
"l" = (
/obj/structure/table,
/obj/item/key,
/turf/open/floor/mineral/titanium/white,
/area/ruins/space/powered/generic)
"m" = (
/obj/effect/spawner/structure/window/shuttle,
/turf/open/floor/plating,
/area/ruins/space/powered/generic)
"n" = (
/obj/item/reagent_containers/glass/bottle/drugs,
/obj/effect/decal/cleanable/cobweb/cobweb2,
/obj/structure/bed,
/obj/machinery/light/broken{
	dir = 1
	},
/obj/effect/turf_decal/ramp_middle,
/turf/open/floor/mineral/titanium/yellow,
/area/ruins/space/powered/generic)
"o" = (
/turf/closed/wall/mineral/titanium,
/area/ruins/space/powered/generic)
"p" = (
/turf/template_noop,
/area/template_noop)
"r" = (
/obj/item/reagent_containers/food/drinks/beer,
/turf/open/floor/mineral/titanium/yellow,
/area/ruins/space/powered/generic)
"s" = (
/turf/open/floor/plating/airless,
/area/ruins/space/powered/generic)
"t" = (
/obj/structure/window/reinforced{
	dir = 1
	},
/obj/structure/shuttle/engine/heater,
/turf/open/floor/plating/airless,
/area/ruins/space/powered/generic)
"u" = (
/obj/structure/shuttle/engine/large,
/turf/open/floor/plating/airless,
/area/ruins/space/powered/generic)
"v" = (
/obj/item/reagent_containers/food/drinks/beer,
/turf/open/floor/mineral/titanium/blue,
/area/ruins/space/powered/generic)
"w" = (
/obj/item/paper/crumpled/bloody/hippie,
/obj/item/cigbutt/roach,
/obj/structure/light_construct{
	dir = 4
	},
/turf/open/floor/mineral/titanium/yellow,
/area/ruins/space/powered/generic)
"x" = (
/turf/open/floor/plasteel/stairs/goon/stairs_wide{
	dir = 1
	},
/area/ruins/space/powered/generic)
"y" = (
/obj/item/reagent_containers/syringe,
/obj/item/reagent_containers/food/drinks/beer,
/turf/open/floor/mineral/titanium/yellow,
/area/ruins/space/powered/generic)
"z" = (
/obj/machinery/computer/shuttle,
/turf/open/floor/mineral/titanium/white,
/area/ruins/space/powered/generic)
"A" = (
/turf/open/floor/plasteel/stairs/goon/stairs2_wide{
	dir = 1
	},
/area/ruins/space/powered/generic)
"B" = (
/obj/effect/turf_decal/ramp_middle,
/turf/open/floor/mineral/titanium/yellow,
/area/ruins/space/powered/generic)
"D" = (
/obj/item/reagent_containers/syringe,
/turf/open/floor/mineral/titanium/yellow,
/area/ruins/space/powered/generic)
"F" = (
/obj/machinery/door/poddoor/shutters{
	id = "HippieVan"
	},
/obj/structure/fans/tiny,
/obj/effect/turf_decal/ramp_corner{
	dir = 4
	},
/turf/open/floor/mineral/titanium/yellow,
/area/ruins/space/powered/generic)
"J" = (
/obj/machinery/door/airlock/shuttle,
/obj/structure/fans/tiny,
/turf/open/floor/mineral/titanium/blue,
/area/ruins/space/powered/generic)
"L" = (
/obj/structure/closet/wardrobe/mixed,
/turf/open/floor/mineral/titanium/yellow,
/area/ruins/space/powered/generic)
"O" = (
/obj/effect/decal/remains/human,
/turf/open/floor/mineral/titanium/blue,
/area/ruins/space/powered/generic)
"P" = (
/obj/item/reagent_containers/food/snacks/grown/ambrosia/vulgaris,
/obj/item/lighter,
/obj/effect/turf_decal/ramp_middle,
/turf/open/floor/mineral/titanium/yellow,
/area/ruins/space/powered/generic)
"R" = (
/obj/item/clothing/mask/cigarette/rollie/trippy,
/obj/effect/decal/cleanable/blood/tracks,
/turf/open/floor/mineral/titanium/yellow,
/area/ruins/space/powered/generic)
"S" = (
/obj/item/reagent_containers/syringe{
	desc = "A syringe, looks like someone used it to inject weed into themselves.";
	name = "weed syringe"
	},
/obj/item/stack/cable_coil,
/turf/open/floor/mineral/titanium/yellow,
/area/ruins/space/powered/generic)
"U" = (
/obj/structure/chair/comfy{
	dir = 1;
	icon_state = "comfychair";
	tag = ""
	},
/obj/machinery/light{
	dir = 4
	},
/turf/open/floor/mineral/titanium/blue,
/area/ruins/space/powered/generic)
"V" = (
/turf/open/floor/mineral/titanium/blue,
/area/ruins/space/powered/generic)
"Y" = (
/obj/structure/shuttle/engine/heater,
/obj/structure/window/reinforced{
	dir = 1
	},
/turf/open/floor/plating/airless,
/area/ruins/space/powered/generic)
"Z" = (
/obj/effect/decal/remains/human,
/turf/open/floor/mineral/titanium/yellow,
/area/ruins/space/powered/generic)

(1,1,1) = {"
p
p
p
p
p
p
p
p
p
p
p
p
p
p
"}
(2,1,1) = {"
p
p
p
p
p
p
p
p
p
p
p
p
p
p
"}
(3,1,1) = {"
p
p
p
p
p
p
p
p
p
p
p
p
p
p
"}
(4,1,1) = {"
p
p
p
p
p
p
p
p
p
p
p
p
p
p
"}
(5,1,1) = {"
p
o
o
J
e
F
b
b
o
o
p
p
p
p
"}
(6,1,1) = {"
p
m
g
O
o
d
R
k
L
Y
h
p
p
p
"}
(7,1,1) = {"
p
m
z
V
x
B
k
D
k
t
s
u
p
p
"}
(8,1,1) = {"
p
m
l
v
A
P
S
j
r
t
s
s
p
p
"}
(9,1,1) = {"
p
m
U
V
o
n
w
Z
y
Y
h
p
p
p
"}
(10,1,1) = {"
p
o
o
J
o
o
m
m
o
o
p
p
p
p
"}
(11,1,1) = {"
p
p
p
p
p
p
p
p
p
p
p
p
p
p
"}
(12,1,1) = {"
p
p
p
p
p
p
p
p
p
p
p
p
p
p
"}
(13,1,1) = {"
p
p
p
p
p
p
p
p
p
p
p
p
p
p
"}
(14,1,1) = {"
p
p
p
p
p
p
p
p
p
p
p
p
p
p
"}
