//MAP CONVERTED BY dmm2tgm.py THIS HEADER COMMENT PREVENTS RECONVERSION, DO NOT REMOVE
"a" = (
/turf/template_noop,
/area/template_noop)
"b" = (
/obj/structure/lattice,
/turf/template_noop,
/area/space/nearstation)
"c" = (
/turf/open/floor/plating/airless,
/area/ruins/space/no_gravity/abandoned_teleporter)
"d" = (
/turf/closed/wall/r_wall,
/area/ruins/space/no_gravity/abandoned_teleporter)
"e" = (
/turf/open/floor/plasteel/airless,
/area/ruins/space/no_gravity/abandoned_teleporter)
"f" = (
/turf/open/floor/plasteel/airless{
	icon_state = "damaged2"
	},
/area/ruins/space/no_gravity/abandoned_teleporter)
"g" = (
/obj/structure/light_construct/small{
	dir = 1
	},
/turf/open/floor/plasteel/airless{
	icon_state = "damaged3"
	},
/area/ruins/space/no_gravity/abandoned_teleporter)
"h" = (
/obj/machinery/computer/teleporter{
	dir = 1
	},
/turf/open/floor/plasteel/airless,
/area/ruins/space/no_gravity/abandoned_teleporter)
"i" = (
/obj/machinery/teleport/station,
/turf/open/floor/plasteel/airless)
"j" = (
/obj/machinery/teleport/hub,
/turf/open/floor/plasteel/airless,
/area/ruins/space/no_gravity/abandoned_teleporter)
"k" = (
/obj/structure/light_construct/small{
	dir = 4
	},
/turf/open/floor/plating/airless,
/area/ruins/space/no_gravity/abandoned_teleporter)
"l" = (
/obj/structure/table,
/obj/item/stock_parts/cell{
	charge = 100;
	maxcharge = 15000
	},
/turf/open/floor/plasteel/airless,
/area/ruins/space/no_gravity/abandoned_teleporter)
"m" = (
/turf/open/floor/plasteel/airless{
	icon_state = "damaged4"
	},
/area/ruins/space/no_gravity/abandoned_teleporter)
"n" = (
/obj/machinery/power/apc{
	name = "Worn-out APC";
	pixel_y = -23
	},
/turf/open/floor/plasteel/airless,
/area/ruins/space/no_gravity/abandoned_teleporter)

(1,1,1) = {"
a
a
a
a
b
a
a
a
a
a
a
a
"}
(2,1,1) = {"
a
a
a
a
b
b
a
a
a
a
a
a
"}
(3,1,1) = {"
a
a
a
b
b
b
a
a
a
a
a
a
"}
(4,1,1) = {"
a
a
a
b
b
b
a
a
a
a
a
a
"}
(5,1,1) = {"
a
a
a
b
b
b
d
d
d
d
d
a
"}
(6,1,1) = {"
a
a
a
b
b
d
d
g
e
l
d
d
"}
(7,1,1) = {"
a
a
a
b
b
d
c
e
e
m
e
d
"}
(8,1,1) = {"
a
a
a
b
c
d
c
e
h
c
n
d
"}
(9,1,1) = {"
a
a
a
b
c
c
e
e
i
e
e
d
"}
(10,1,1) = {"
a
a
a
b
c
d
f
e
j
e
e
d
"}
(11,1,1) = {"
b
b
b
b
c
d
e
e
e
e
c
c
"}
(12,1,1) = {"
a
b
a
b
b
d
c
e
k
f
d
c
"}
(13,1,1) = {"
b
b
b
b
b
c
c
d
d
d
d
a
"}
(14,1,1) = {"
b
b
b
b
b
c
b
b
b
a
a
a
"}
(15,1,1) = {"
b
b
b
b
b
c
b
a
a
a
a
a
"}
(16,1,1) = {"
b
b
b
b
b
b
a
a
a
a
a
a
"}
(17,1,1) = {"
b
b
b
b
b
a
a
a
a
a
a
a
"}
(18,1,1) = {"
a
b
b
b
a
a
a
a
a
a
a
a
"}
(19,1,1) = {"
a
b
b
b
b
b
b
a
a
a
a
a
"}
(20,1,1) = {"
b
b
b
a
b
b
a
a
a
a
a
a
"}
(21,1,1) = {"
a
b
a
a
b
b
a
a
a
a
a
a
"}
