//MAP CONVERTED BY dmm2tgm.py THIS HEADER COMMENT PREVENTS RECONVERSION, DO NOT REMOVE
"aa" = (
/turf/template_noop,
/area/template_noop)
"ab" = (
/obj/structure/cable{
	icon_state = "2-4"
	},
/obj/structure/lattice/catwalk,
/turf/template_noop,
/area/space/nearstation)
"ac" = (
/obj/structure/cable{
	icon_state = "4-8"
	},
/obj/structure/lattice/catwalk,
/turf/template_noop,
/area/space/nearstation)
"ad" = (
/obj/structure/cable{
	icon_state = "2-8"
	},
/obj/structure/lattice/catwalk,
/turf/template_noop,
/area/space/nearstation)
"ae" = (
/obj/item/stack/cable_coil/cut/red{
	amount = 2
	},
/obj/structure/lattice/catwalk,
/turf/template_noop,
/area/space/nearstation)
"af" = (
/obj/structure/cable{
	icon_state = "1-8"
	},
/obj/structure/lattice/catwalk,
/turf/template_noop,
/area/space/nearstation)
"ag" = (
/turf/closed/wall,
/area/ruins/space/onehalf_med)
"ah" = (
/obj/effect/spawner/structure/window/reinforced,
/turf/open/floor/plating,
/area/ruins/space/onehalf_med)
"ai" = (
/obj/structure/cable{
	icon_state = "1-2"
	},
/obj/structure/lattice/catwalk,
/turf/template_noop,
/area/space/nearstation)
"aj" = (
/turf/open/floor/plating/airless,
/area/ruins/space/onehalf_hallway)
"ak" = (
/turf/closed/wall,
/area/ruins/space/onehalf_hallway)
"al" = (
/obj/machinery/sleeper/syndie{
	dir = 4
	},
/turf/open/floor/plasteel/white,
/area/ruins/space/onehalf_med)
"am" = (
/turf/open/floor/plasteel/white,
/area/ruins/space/onehalf_med)
"an" = (
/obj/structure/table,
/obj/item/storage/firstaid/toxin{
	pixel_x = 3;
	pixel_y = 3
	},
/obj/item/storage/firstaid/fire,
/turf/open/floor/plasteel/white,
/area/ruins/space/onehalf_med)
"ao" = (
/obj/structure/bed,
/obj/item/bedsheet/black,
/turf/open/floor/plasteel,
/area/ruins/space/onehalf_med)
"ap" = (
/turf/open/floor/plasteel,
/area/ruins/space/onehalf_med)
"aq" = (
/obj/machinery/door/airlock/external,
/obj/structure/cable{
	icon_state = "1-2"
	},
/obj/effect/mapping_helpers/airlock/cyclelink_helper,
/turf/open/floor/plating,
/area/ruins/space/onehalf_drone)
"ar" = (
/turf/closed/wall,
/area/ruins/space/onehalf_drone)
"as" = (
/obj/machinery/door/poddoor{
	id = "onehalf_drone1ext";
	name = "mining drone bay blast door"
	},
/obj/effect/turf_decal/stripes/line{
	dir = 1
	},
/turf/open/floor/plating/airless,
/area/ruins/space/onehalf_drone)
"at" = (
/obj/machinery/door/poddoor{
	id = "onehalf_drone2ext";
	name = "mining drone bay blast door"
	},
/obj/effect/turf_decal/stripes/line{
	dir = 1
	},
/turf/open/floor/plating/airless,
/area/ruins/space/onehalf_drone)
"au" = (
/obj/machinery/door/poddoor/preopen{
	id = "onehalf_drone3ext";
	name = "mining drone bay blast door"
	},
/obj/effect/turf_decal/stripes/line{
	dir = 1
	},
/turf/open/floor/plating/airless,
/area/ruins/space/onehalf_drone)
"av" = (
/obj/machinery/door/poddoor{
	id = "onehalf_drone4ext";
	name = "mining drone bay blast door"
	},
/obj/effect/turf_decal/stripes/line{
	dir = 1
	},
/turf/open/floor/plating/airless,
/area/ruins/space/onehalf_drone)
"aw" = (
/obj/structure/lattice,
/turf/template_noop,
/area/template_noop)
"ax" = (
/obj/structure/lattice,
/obj/item/shard{
	icon_state = "medium"
	},
/turf/template_noop,
/area/space/nearstation)
"ay" = (
/obj/structure/table_frame,
/turf/open/floor/plasteel/airless{
	icon_state = "damaged3"
	},
/area/ruins/space/onehalf_hallway)
"az" = (
/obj/machinery/washing_machine,
/turf/open/floor/plasteel/airless,
/area/ruins/space/onehalf_hallway)
"aA" = (
/obj/item/roller,
/turf/open/floor/plasteel/white,
/area/ruins/space/onehalf_med)
"aB" = (
/obj/machinery/light{
	dir = 4
	},
/obj/structure/table,
/obj/item/storage/firstaid/brute{
	pixel_x = 3;
	pixel_y = 3
	},
/obj/item/storage/firstaid/regular,
/turf/open/floor/plasteel/white,
/area/ruins/space/onehalf_med)
"aC" = (
/obj/machinery/light{
	dir = 8
	},
/turf/open/floor/plasteel,
/area/ruins/space/onehalf_med)
"aD" = (
/obj/structure/cable{
	icon_state = "1-2"
	},
/obj/machinery/light/small{
	dir = 8
	},
/turf/open/floor/plating,
/area/ruins/space/onehalf_drone)
"aE" = (
/obj/structure/disposalpipe/trunk,
/turf/open/floor/plating/airless,
/area/ruins/space/onehalf_drone)
"aF" = (
/obj/structure/disposalpipe/trunk,
/obj/item/stack/ore/diamond,
/turf/open/floor/plating/airless,
/area/ruins/space/onehalf_drone)
"aG" = (
/obj/effect/turf_decal/stripes/line{
	dir = 1
	},
/turf/open/floor/plating/airless,
/area/ruins/space/onehalf_drone)
"aH" = (
/obj/structure/lattice,
/obj/item/stack/cable_coil/cut/red{
	amount = 2
	},
/turf/template_noop,
/area/space/nearstation)
"aI" = (
/turf/open/floor/plating/airless{
	icon_state = "platingdmg3"
	},
/area/ruins/space/onehalf_hallway)
"aJ" = (
/turf/open/floor/plasteel/airless{
	icon_state = "damaged5"
	},
/area/ruins/space/onehalf_hallway)
"aK" = (
/obj/machinery/iv_drip,
/turf/open/floor/plasteel/white,
/area/ruins/space/onehalf_med)
"aL" = (
/obj/structure/cable{
	icon_state = "2-4"
	},
/turf/open/floor/plasteel/white,
/area/ruins/space/onehalf_med)
"aM" = (
/obj/structure/cable{
	icon_state = "0-8"
	},
/obj/structure/closet/crate/medical,
/obj/item/clothing/neck/stethoscope,
/obj/item/healthanalyzer,
/obj/item/reagent_containers/blood/OMinus,
/obj/item/reagent_containers/blood/OMinus,
/obj/machinery/power/apc{
	dir = 4;
	name = "Crew Quarters APC";
	pixel_x = 24
	},
/turf/open/floor/plasteel/white,
/area/ruins/space/onehalf_med)
"aN" = (
/obj/structure/disposalpipe/segment,
/obj/machinery/door/poddoor{
	id = "onehalf_drone1int";
	name = "mining drone bay blast door"
	},
/turf/open/floor/plating,
/area/ruins/space/onehalf_drone)
"aO" = (
/obj/structure/disposalpipe/segment,
/obj/machinery/door/poddoor{
	id = "onehalf_drone2int";
	name = "mining drone bay blast door"
	},
/turf/open/floor/plating,
/area/ruins/space/onehalf_drone)
"aP" = (
/obj/structure/disposalpipe/segment,
/obj/machinery/door/poddoor{
	id = "onehalf_drone3int";
	name = "mining drone bay blast door"
	},
/turf/open/floor/plating,
/area/ruins/space/onehalf_drone)
"aQ" = (
/obj/structure/disposalpipe/segment,
/obj/machinery/door/poddoor{
	id = "onehalf_drone4int";
	name = "mining drone bay blast door"
	},
/turf/open/floor/plating,
/area/ruins/space/onehalf_drone)
"aR" = (
/obj/structure/disposaloutlet{
	dir = 1
	},
/obj/structure/disposalpipe/trunk,
/turf/open/floor/plating/airless,
/area/ruins/space/onehalf_drone)
"aS" = (
/obj/structure/lattice,
/obj/item/storage/toolbox/syndicate,
/turf/template_noop,
/area/space/nearstation)
"aT" = (
/obj/structure/cable{
	icon_state = "1-2"
	},
/turf/open/floor/plasteel/airless{
	icon_state = "damaged3"
	},
/area/ruins/space/onehalf_hallway)
"aU" = (
/turf/open/floor/plasteel/airless{
	icon_state = "damaged1"
	},
/area/ruins/space/onehalf_hallway)
"aV" = (
/obj/machinery/door/airlock/medical/glass,
/obj/structure/cable{
	icon_state = "1-2"
	},
/turf/open/floor/plasteel/white,
/area/ruins/space/onehalf_med)
"aW" = (
/obj/machinery/door/airlock,
/turf/open/floor/plasteel,
/area/ruins/space/onehalf_med)
"aX" = (
/obj/structure/cable{
	icon_state = "1-4"
	},
/obj/structure/cable{
	icon_state = "1-2"
	},
/obj/effect/turf_decal/stripes/line{
	dir = 9
	},
/turf/open/floor/plasteel,
/area/ruins/space/onehalf_drone)
"aY" = (
/obj/structure/cable{
	icon_state = "0-8"
	},
/obj/machinery/power/apc{
	dir = 1;
	name = "Mining Drone Bay APC";
	pixel_y = 23
	},
/obj/effect/turf_decal/stripes/line{
	dir = 1
	},
/turf/open/floor/plasteel,
/area/ruins/space/onehalf_drone)
"aZ" = (
/obj/structure/disposalpipe/segment,
/obj/effect/turf_decal/stripes/line{
	dir = 1
	},
/turf/open/floor/plasteel,
/area/ruins/space/onehalf_drone)
"ba" = (
/obj/machinery/button/door{
	id = "onehalf_drone2int";
	name = "Drone 2 Internal Hatch Override";
	pixel_x = 8;
	pixel_y = 27
	},
/obj/machinery/button/door{
	id = "onehalf_drone2ext";
	name = "Drone 2 External Hatch Override";
	pixel_x = 8;
	pixel_y = 37
	},
/obj/machinery/button/door{
	id = "onehalf_drone1int";
	name = "Drone 1 Internal Hatch Override";
	pixel_x = -8;
	pixel_y = 27
	},
/obj/machinery/button/door{
	id = "onehalf_drone1ext";
	name = "Drone 1 External Hatch Override";
	pixel_x = -8;
	pixel_y = 37
	},
/obj/effect/turf_decal/stripes/line{
	dir = 1
	},
/turf/open/floor/plasteel,
/area/ruins/space/onehalf_drone)
"bb" = (
/obj/effect/turf_decal/stripes/line{
	dir = 1
	},
/turf/open/floor/plasteel,
/area/ruins/space/onehalf_drone)
"bc" = (
/obj/machinery/button/door{
	id = "onehalf_drone3int";
	name = "Drone 3 Internal Hatch Override";
	pixel_x = -8;
	pixel_y = 27
	},
/obj/machinery/button/door{
	id = "onehalf_drone3ext";
	name = "Drone 3 External Hatch Override";
	pixel_x = -8;
	pixel_y = 37
	},
/obj/machinery/button/door{
	id = "onehalf_drone4ext";
	name = "Drone 4 External Hatch Override";
	pixel_x = 8;
	pixel_y = 37
	},
/obj/machinery/button/door{
	id = "onehalf_drone4int";
	name = "Drone 4 Internal Hatch Override";
	pixel_x = 8;
	pixel_y = 27
	},
/obj/effect/turf_decal/stripes/line{
	dir = 1
	},
/turf/open/floor/plasteel,
/area/ruins/space/onehalf_drone)
"bd" = (
/obj/structure/disposalpipe/segment,
/obj/effect/turf_decal/stripes/line{
	dir = 5
	},
/turf/open/floor/plasteel,
/area/ruins/space/onehalf_drone)
"be" = (
/obj/effect/spawner/structure/window/reinforced,
/turf/open/floor/plating,
/area/ruins/space/onehalf_drone)
"bf" = (
/obj/item/stack/sheet/metal,
/turf/open/floor/plating/airless{
	icon_state = "platingdmg1"
	},
/area/ruins/space/onehalf_hallway)
"bg" = (
/obj/structure/disposalpipe/broken{
	dir = 4
	},
/obj/item/stack/cable_coil/cut/red{
	amount = 2
	},
/turf/open/floor/plating/airless{
	icon_state = "platingdmg2"
	},
/area/ruins/space/onehalf_hallway)
"bh" = (
/obj/structure/disposalpipe/segment{
	dir = 4
	},
/obj/structure/cable{
	icon_state = "4-8"
	},
/obj/structure/cable{
	icon_state = "1-4"
	},
/turf/open/floor/plasteel/airless{
	icon_state = "damaged3"
	},
/area/ruins/space/onehalf_hallway)
"bi" = (
/obj/structure/disposalpipe/segment{
	dir = 4
	},
/obj/structure/cable{
	icon_state = "4-8"
	},
/turf/open/floor/plasteel/airless{
	icon_state = "damaged5"
	},
/area/ruins/space/onehalf_hallway)
"bj" = (
/obj/structure/disposalpipe/segment{
	dir = 4
	},
/obj/structure/cable{
	icon_state = "4-8"
	},
/turf/open/floor/plasteel/airless,
/area/ruins/space/onehalf_hallway)
"bk" = (
/obj/structure/disposalpipe/junction{
	dir = 4
	},
/obj/structure/cable{
	icon_state = "1-4"
	},
/obj/structure/cable{
	icon_state = "4-8"
	},
/turf/open/floor/plasteel/airless{
	icon_state = "damaged1"
	},
/area/ruins/space/onehalf_hallway)
"bl" = (
/obj/structure/disposalpipe/segment{
	dir = 4
	},
/obj/structure/cable{
	icon_state = "4-8"
	},
/obj/structure/cable{
	icon_state = "2-8"
	},
/turf/open/floor/plasteel/airless,
/area/ruins/space/onehalf_hallway)
"bm" = (
/obj/structure/disposalpipe/junction{
	dir = 4
	},
/obj/structure/cable{
	icon_state = "4-8"
	},
/turf/open/floor/plasteel/airless,
/area/ruins/space/onehalf_hallway)
"bn" = (
/obj/structure/disposalpipe/segment{
	dir = 4
	},
/obj/machinery/door/airlock/public/glass,
/obj/structure/cable{
	icon_state = "4-8"
	},
/turf/open/floor/plasteel,
/area/ruins/space/onehalf_drone)
"bo" = (
/obj/structure/disposalpipe/segment{
	dir = 4
	},
/obj/structure/cable{
	icon_state = "1-8"
	},
/turf/open/floor/plasteel,
/area/ruins/space/onehalf_drone)
"bp" = (
/obj/structure/disposalpipe/segment{
	dir = 4
	},
/turf/open/floor/plasteel,
/area/ruins/space/onehalf_drone)
"bq" = (
/obj/structure/disposalpipe/segment{
	dir = 4
	},
/obj/structure/disposalpipe/segment,
/turf/open/floor/plasteel,
/area/ruins/space/onehalf_drone)
"br" = (
/obj/structure/disposalpipe/segment{
	dir = 4
	},
/obj/machinery/door/airlock/maintenance_hatch,
/turf/open/floor/plasteel,
/area/ruins/space/onehalf_drone)
"bs" = (
/obj/structure/disposalpipe/segment{
	dir = 4
	},
/obj/machinery/light/small{
	dir = 1
	},
/obj/effect/decal/cleanable/dirt,
/turf/open/floor/plasteel,
/area/ruins/space/onehalf_drone)
"bt" = (
/obj/structure/disposalpipe/junction/yjunction{
	dir = 1
	},
/obj/effect/decal/cleanable/dirt,
/turf/open/floor/plasteel,
/area/ruins/space/onehalf_drone)
"bu" = (
/obj/structure/disposalpipe/trunk{
	dir = 8
	},
/obj/machinery/disposal/bin,
/turf/open/floor/plating,
/area/ruins/space/onehalf_drone)
"bv" = (
/obj/structure/disposalpipe/broken{
	dir = 4
	},
/turf/open/floor/plating/airless{
	icon_state = "platingdmg3"
	},
/area/ruins/space/onehalf_hallway)
"bw" = (
/obj/structure/disposalpipe/segment{
	dir = 4
	},
/turf/open/floor/plasteel/airless{
	icon_state = "damaged3"
	},
/area/ruins/space/onehalf_hallway)
"bx" = (
/obj/structure/disposalpipe/segment{
	dir = 4
	},
/turf/open/floor/plasteel/airless,
/area/ruins/space/onehalf_hallway)
"by" = (
/obj/structure/disposalpipe/segment,
/obj/structure/disposalpipe/segment{
	dir = 4
	},
/turf/open/floor/plasteel/airless{
	icon_state = "damaged1"
	},
/area/ruins/space/onehalf_hallway)
"bz" = (
/obj/structure/disposalpipe/segment{
	dir = 4
	},
/obj/structure/cable,
/obj/machinery/power/apc{
	dir = 2;
	name = "Hallway APC";
	pixel_y = -23
	},
/turf/open/floor/plasteel/airless,
/area/ruins/space/onehalf_hallway)
"bA" = (
/obj/structure/disposalpipe/segment{
	dir = 4
	},
/turf/open/floor/plasteel/airless{
	icon_state = "damaged4"
	},
/area/ruins/space/onehalf_hallway)
"bB" = (
/obj/structure/disposalpipe/segment,
/obj/structure/disposalpipe/segment{
	dir = 4
	},
/turf/open/floor/plasteel/airless,
/area/ruins/space/onehalf_hallway)
"bC" = (
/obj/machinery/door/airlock/public/glass,
/obj/structure/disposalpipe/segment{
	dir = 4
	},
/turf/open/floor/plasteel,
/area/ruins/space/onehalf_drone)
"bD" = (
/obj/structure/disposalpipe/junction{
	dir = 8
	},
/turf/open/floor/plasteel,
/area/ruins/space/onehalf_drone)
"bE" = (
/obj/structure/disposalpipe/segment{
	dir = 4
	},
/obj/machinery/light,
/turf/open/floor/plasteel,
/area/ruins/space/onehalf_drone)
"bF" = (
/obj/structure/disposalpipe/segment{
	dir = 9
	},
/turf/open/floor/plasteel,
/area/ruins/space/onehalf_drone)
"bG" = (
/turf/open/floor/plasteel,
/area/ruins/space/onehalf_drone)
"bH" = (
/obj/machinery/portable_atmospherics/canister/oxygen,
/obj/effect/decal/cleanable/dirt,
/turf/open/floor/plasteel,
/area/ruins/space/onehalf_drone)
"bI" = (
/obj/effect/decal/cleanable/dirt,
/turf/open/floor/plasteel,
/area/ruins/space/onehalf_drone)
"bJ" = (
/obj/structure/chair/office{
	dir = 4
	},
/obj/effect/decal/cleanable/dirt,
/turf/open/floor/plasteel,
/area/ruins/space/onehalf_drone)
"bK" = (
/obj/structure/girder,
/turf/open/floor/plating/airless,
/area/ruins/space/onehalf_hallway)
"bL" = (
/obj/structure/closet/emcloset,
/turf/open/floor/plasteel/airless{
	icon_state = "damaged4"
	},
/area/ruins/space/onehalf_hallway)
"bM" = (
/obj/machinery/vending/coffee,
/turf/open/floor/plasteel/airless{
	icon_state = "damaged4"
	},
/area/ruins/space/onehalf_hallway)
"bN" = (
/obj/machinery/vending/snack,
/turf/open/floor/plasteel/airless{
	icon_state = "damaged2"
	},
/area/ruins/space/onehalf_hallway)
"bO" = (
/obj/structure/disposalpipe/trunk{
	dir = 1
	},
/obj/machinery/disposal/bin,
/turf/open/floor/plasteel/airless,
/area/ruins/space/onehalf_hallway)
"bP" = (
/obj/structure/girder/reinforced,
/obj/item/stack/sheet/plasteel,
/turf/open/floor/plating/airless,
/area/ruins/space/onehalf_hallway)
"bQ" = (
/obj/structure/girder/reinforced,
/turf/open/floor/plating/airless,
/area/ruins/space/onehalf_hallway)
"bR" = (
/turf/closed/wall/r_wall,
/area/ruins/space/onehalf_hallway)
"bS" = (
/turf/open/floor/plasteel/airless{
	icon_state = "damaged2"
	},
/area/ruins/space/onehalf_hallway)
"bT" = (
/obj/structure/disposalpipe/segment,
/turf/open/floor/plasteel/airless,
/area/ruins/space/onehalf_hallway)
"bU" = (
/turf/closed/wall/r_wall,
/area/ruins/space/onehalf_bridge)
"bV" = (
/obj/item/stack/sheet/metal,
/turf/template_noop,
/area/template_noop)
"bW" = (
/turf/open/floor/plating/airless{
	icon_state = "platingdmg1"
	},
/area/ruins/space/onehalf_hallway)
"bX" = (
/obj/structure/disposalpipe/segment,
/obj/item/stack/rods,
/turf/open/floor/plasteel/airless{
	icon_state = "damaged5"
	},
/area/ruins/space/onehalf_hallway)
"bY" = (
/obj/structure/grille,
/turf/open/floor/plating/airless,
/area/ruins/space/onehalf_hallway)
"bZ" = (
/obj/effect/spawner/structure/window/reinforced,
/obj/machinery/door/poddoor/preopen{
	id = "bridge_onehalf";
	name = "bridge blast door"
	},
/turf/open/floor/plating,
/area/ruins/space/onehalf_bridge)
"ca" = (
/obj/structure/table/reinforced,
/obj/item/flashlight/lamp,
/turf/open/floor/plasteel,
/area/ruins/space/onehalf_bridge)
"cb" = (
/obj/structure/table/reinforced,
/obj/item/paper,
/obj/item/pen,
/turf/open/floor/plasteel,
/area/ruins/space/onehalf_bridge)
"cc" = (
/obj/structure/closet/emcloset,
/turf/open/floor/plasteel,
/area/ruins/space/onehalf_bridge)
"cd" = (
/obj/machinery/light{
	dir = 1
	},
/obj/structure/frame/computer,
/turf/open/floor/plasteel,
/area/ruins/space/onehalf_bridge)
"ce" = (
/obj/structure/frame/computer,
/turf/open/floor/plasteel,
/area/ruins/space/onehalf_bridge)
"cf" = (
/obj/structure/cable{
	icon_state = "0-4"
	},
/obj/machinery/power/apc{
	dir = 1;
	name = "Bridge APC";
	pixel_y = 23
	},
/turf/open/floor/plasteel,
/area/ruins/space/onehalf_bridge)
"cg" = (
/obj/structure/cable{
	icon_state = "2-8"
	},
/obj/structure/table/reinforced,
/obj/item/stack/spacecash/c500{
	pixel_y = 8
	},
/obj/item/stack/spacecash/c1000,
/turf/open/floor/plasteel,
/area/ruins/space/onehalf_bridge)
"ch" = (
/obj/structure/disposalpipe/junction{
	dir = 1
	},
/obj/item/shard,
/turf/open/floor/plating/airless{
	icon_state = "platingdmg2"
	},
/area/ruins/space/onehalf_hallway)
"ci" = (
/obj/structure/lattice,
/obj/structure/disposalpipe/broken{
	dir = 4
	},
/obj/structure/disposalpipe/broken{
	dir = 8
	},
/obj/item/stack/rods,
/turf/template_noop,
/area/space/nearstation)
"cj" = (
/obj/structure/lattice,
/obj/structure/disposalpipe/segment{
	dir = 4
	},
/obj/item/shard{
	icon_state = "small"
	},
/turf/template_noop,
/area/space/nearstation)
"ck" = (
/obj/effect/spawner/structure/window/reinforced,
/obj/structure/disposalpipe/segment{
	dir = 4
	},
/obj/machinery/door/poddoor/preopen{
	id = "bridge_onehalf";
	name = "bridge blast door"
	},
/turf/open/floor/plating,
/area/ruins/space/onehalf_bridge)
"cl" = (
/obj/structure/disposalpipe/segment{
	dir = 10
	},
/obj/structure/table/reinforced,
/obj/item/paper_bin{
	total_paper = 12
	},
/turf/open/floor/plasteel,
/area/ruins/space/onehalf_bridge)
"cm" = (
/obj/structure/chair/office{
	dir = 8
	},
/turf/open/floor/plasteel,
/area/ruins/space/onehalf_bridge)
"cn" = (
/turf/open/floor/plasteel,
/area/ruins/space/onehalf_bridge)
"co" = (
/obj/structure/chair/office{
	dir = 1
	},
/turf/open/floor/plasteel,
/area/ruins/space/onehalf_bridge)
"cp" = (
/obj/structure/cable{
	icon_state = "1-4"
	},
/obj/structure/cable{
	icon_state = "2-4"
	},
/obj/structure/table/reinforced,
/obj/item/lighter,
/turf/open/floor/plasteel,
/area/ruins/space/onehalf_bridge)
"cq" = (
/obj/effect/spawner/structure/window/reinforced,
/obj/structure/cable{
	icon_state = "0-4"
	},
/obj/structure/cable{
	icon_state = "0-2"
	},
/obj/structure/cable{
	icon_state = "0-8"
	},
/obj/machinery/door/poddoor/preopen{
	id = "bridge_onehalf";
	name = "bridge blast door"
	},
/turf/open/floor/plating,
/area/ruins/space/onehalf_bridge)
"cr" = (
/obj/item/stack/rods,
/turf/template_noop,
/area/template_noop)
"cs" = (
/obj/item/stack/sheet/plasteel{
	amount = 10
	},
/obj/structure/lattice,
/turf/template_noop,
/area/space/nearstation)
"ct" = (
/obj/machinery/door/airlock/external,
/obj/structure/cable{
	icon_state = "1-2"
	},
/obj/effect/mapping_helpers/airlock/cyclelink_helper{
	dir = 1
	},
/turf/open/floor/plating,
/area/ruins/space/onehalf_drone)
"cu" = (
/obj/structure/disposalpipe/segment,
/turf/open/floor/plasteel/airless{
	icon_state = "damaged5"
	},
/area/ruins/space/onehalf_hallway)
"cv" = (
/obj/structure/girder/reinforced,
/turf/open/floor/plating/airless,
/area/ruins/space/onehalf_bridge)
"cw" = (
/obj/structure/disposalpipe/trunk{
	dir = 1
	},
/obj/machinery/disposal/bin,
/turf/open/floor/plasteel,
/area/ruins/space/onehalf_bridge)
"cx" = (
/obj/item/stack/tile/plasteel,
/turf/open/floor/plasteel,
/area/ruins/space/onehalf_bridge)
"cy" = (
/obj/structure/cable,
/obj/machinery/power/solar_control{
	dir = 8;
	icon_state = "computer"
	},
/turf/open/floor/plasteel,
/area/ruins/space/onehalf_bridge)
"cz" = (
/obj/effect/spawner/structure/window/reinforced,
/obj/structure/cable,
/obj/structure/cable{
	icon_state = "0-2"
	},
/obj/machinery/door/poddoor/preopen{
	id = "bridge_onehalf";
	name = "bridge blast door"
	},
/turf/open/floor/plating,
/area/ruins/space/onehalf_bridge)
"cA" = (
/obj/item/stack/tile/wood,
/turf/template_noop,
/area/template_noop)
"cB" = (
/obj/machinery/door/airlock/command/glass{
	name = "Bridge"
	},
/obj/effect/mapping_helpers/airlock/cyclelink_helper{
	dir = 4
	},
/turf/open/floor/plasteel,
/area/ruins/space/onehalf_bridge)
"cC" = (
/obj/machinery/door/poddoor/preopen{
	id = "bridge_onehalf";
	name = "bridge blast door"
	},
/obj/machinery/door/airlock/command/glass{
	name = "Bridge"
	},
/obj/effect/mapping_helpers/airlock/cyclelink_helper{
	dir = 8
	},
/turf/open/floor/plasteel,
/area/ruins/space/onehalf_bridge)
"cD" = (
/obj/structure/lattice,
/obj/structure/disposalpipe/broken{
	dir = 8
	},
/obj/structure/disposalpipe/broken{
	dir = 1
	},
/turf/template_noop,
/area/space/nearstation)
"cE" = (
/obj/structure/frame/computer{
	dir = 8;
	icon_state = "0"
	},
/turf/open/floor/plasteel,
/area/ruins/space/onehalf_bridge)
"cF" = (
/obj/machinery/light/small,
/turf/open/floor/plasteel,
/area/ruins/space/onehalf_bridge)
"cG" = (
/obj/structure/frame/computer{
	dir = 1;
	icon_state = "0"
	},
/turf/open/floor/plasteel,
/area/ruins/space/onehalf_bridge)
"cH" = (
/obj/item/crowbar/red,
/obj/item/multitool,
/turf/open/floor/plating,
/area/ruins/space/onehalf_bridge)
"cI" = (
/obj/structure/safe/floor,
/obj/item/tank/internals/oxygen,
/obj/item/clothing/mask/gas/syndicate,
/obj/item/clothing/suit/space/hardsuit/syndi,
/obj/item/reagent_containers/food/drinks/bottle/rum,
/obj/item/reagent_containers/food/drinks/bottle/rum,
/obj/item/folder/syndicate/mining,
/turf/open/floor/plating,
/area/ruins/space/onehalf_bridge)
"cJ" = (
/obj/structure/chair/comfy/black{
	dir = 4
	},
/turf/open/floor/plasteel,
/area/ruins/space/onehalf_bridge)
"cL" = (
/turf/open/floor/plating/airless{
	icon_state = "platingdmg2"
	},
/area/ruins/space/onehalf_hallway)
"cM" = (
/obj/machinery/light{
	dir = 8
	},
/obj/machinery/vending/sovietsoda,
/turf/open/floor/plasteel,
/area/ruins/space/onehalf_bridge)
"cN" = (
/obj/item/stack/sheet/plasteel,
/turf/template_noop,
/area/template_noop)
"cP" = (
/turf/open/floor/plasteel/airless{
	icon_state = "damaged3"
	},
/area/ruins/space/onehalf_hallway)
"cQ" = (
/obj/effect/spawner/structure/window/reinforced,
/turf/open/floor/plating)
"cR" = (
/obj/structure/table/reinforced,
/obj/machinery/recharger,
/turf/open/floor/plasteel,
/area/ruins/space/onehalf_bridge)
"cS" = (
/obj/structure/chair/office,
/turf/open/floor/plasteel,
/area/ruins/space/onehalf_bridge)
"cT" = (
/obj/machinery/button/door{
	id = "bridge_onehalf";
	name = "Bridge Blast Door";
	pixel_x = 32;
	pixel_y = 5
	},
/turf/open/floor/plasteel,
/area/ruins/space/onehalf_bridge)
"cU" = (
/obj/structure/table/reinforced,
/turf/open/floor/plasteel,
/area/ruins/space/onehalf_bridge)
"cV" = (
/obj/effect/spawner/structure/window/reinforced,
/obj/structure/cable{
	icon_state = "0-4"
	},
/obj/structure/cable,
/obj/machinery/door/poddoor/preopen{
	id = "bridge_onehalf";
	name = "bridge blast door"
	},
/turf/open/floor/plating,
/area/ruins/space/onehalf_bridge)
"cW" = (
/obj/structure/cable{
	icon_state = "1-2"
	},
/obj/structure/cable{
	icon_state = "2-8"
	},
/obj/structure/lattice/catwalk,
/turf/template_noop,
/area/space/nearstation)
"cX" = (
/obj/structure/cable{
	icon_state = "1-2"
	},
/turf/open/floor/plasteel/airless{
	icon_state = "damaged5"
	},
/area/ruins/space/onehalf_hallway)
"cY" = (
/obj/structure/table/reinforced,
/obj/item/flashlight,
/turf/open/floor/plasteel,
/area/ruins/space/onehalf_bridge)
"cZ" = (
/obj/structure/table/reinforced,
/obj/item/stack/ore/bluespace_crystal,
/obj/item/coin/plasma,
/turf/open/floor/plasteel,
/area/ruins/space/onehalf_bridge)
"da" = (
/obj/structure/closet/firecloset/full,
/turf/open/floor/plasteel,
/area/ruins/space/onehalf_bridge)
"db" = (
/obj/machinery/light,
/obj/structure/table/reinforced,
/obj/item/storage/firstaid/regular,
/turf/open/floor/plasteel,
/area/ruins/space/onehalf_bridge)
"dc" = (
/obj/structure/grille/broken,
/obj/structure/cable{
	icon_state = "1-2"
	},
/turf/open/floor/plating/airless{
	icon_state = "platingdmg1"
	},
/area/ruins/space/onehalf_hallway)
"dd" = (
/obj/structure/grille,
/obj/item/shard,
/turf/open/floor/plating/airless{
	icon_state = "platingdmg3"
	},
/area/ruins/space/onehalf_hallway)
"de" = (
/obj/effect/spawner/structure/window/reinforced,
/obj/structure/cable{
	icon_state = "0-2"
	},
/obj/structure/cable{
	icon_state = "0-4"
	},
/obj/machinery/door/poddoor/preopen{
	id = "bridge_onehalf";
	name = "bridge blast door"
	},
/turf/open/floor/plating,
/area/ruins/space/onehalf_bridge)
"df" = (
/obj/effect/spawner/structure/window/reinforced,
/obj/structure/cable{
	icon_state = "0-4"
	},
/obj/structure/cable{
	icon_state = "0-8"
	},
/obj/machinery/door/poddoor/preopen{
	id = "bridge_onehalf";
	name = "bridge blast door"
	},
/turf/open/floor/plating,
/area/ruins/space/onehalf_bridge)
"dg" = (
/obj/effect/spawner/structure/window/reinforced,
/obj/structure/cable{
	icon_state = "0-2"
	},
/obj/structure/cable{
	icon_state = "0-8"
	},
/obj/machinery/door/poddoor/preopen{
	id = "bridge_onehalf";
	name = "bridge blast door"
	},
/turf/open/floor/plating,
/area/ruins/space/onehalf_bridge)
"dh" = (
/obj/item/stack/sheet/plasteel,
/obj/structure/lattice/catwalk,
/turf/template_noop,
/area/space/nearstation)
"di" = (
/obj/structure/cable{
	icon_state = "4-8"
	},
/obj/item/shard{
	icon_state = "medium"
	},
/obj/structure/lattice/catwalk,
/turf/template_noop,
/area/space/nearstation)
"dj" = (
/obj/structure/cable{
	icon_state = "4-8"
	},
/obj/structure/cable{
	icon_state = "1-4"
	},
/obj/item/stack/rods,
/obj/structure/lattice/catwalk,
/turf/template_noop,
/area/space/nearstation)
"dk" = (
/obj/structure/cable{
	icon_state = "1-8"
	},
/obj/structure/cable{
	icon_state = "4-8"
	},
/obj/structure/lattice/catwalk,
/turf/template_noop,
/area/space/nearstation)
"dl" = (
/obj/item/stack/cable_coil/cut/red{
	amount = 2
	},
/turf/template_noop,
/area/template_noop)
"Me" = (
/obj/structure/lattice,
/turf/template_noop,
/area/space/nearstation)

(1,1,1) = {"
aa
aa
aa
aa
Me
aa
aS
Me
aa
aa
aa
aa
aa
aa
aa
aa
aa
aa
aa
aa
"}
(2,1,1) = {"
aa
aa
aa
aj
Me
cr
aj
bf
bv
bK
aa
aa
aa
aa
aa
aa
aa
aa
aa
aa
"}
(3,1,1) = {"
aa
aa
ae
ak
Me
aI
Me
bg
bw
aj
bV
aa
aa
aa
aa
aa
aa
aa
aa
aa
"}
(4,1,1) = {"
aa
aa
ac
ak
ay
Me
aT
bh
bw
ak
bW
aa
aa
aa
aa
aa
aa
aa
aa
aa
"}
(5,1,1) = {"
aa
ab
af
ak
az
aJ
aU
bi
bx
bL
bK
aa
aa
aa
aa
aa
aa
aa
aa
aa
"}
(6,1,1) = {"
aa
ac
ag
ag
ag
ag
ag
bj
bx
bM
ak
aa
cr
aa
aa
aa
aa
aa
aa
aa
"}
(7,1,1) = {"
aa
ac
ag
al
aA
aK
ag
bj
bw
bN
bQ
bQ
aj
aa
aa
aa
aa
aa
aa
aa
"}
(8,1,1) = {"
aa
ac
ag
am
am
aL
aV
bk
by
bO
bR
aa
cs
Me
aa
aa
cr
bP
aa
aa
"}
(9,1,1) = {"
aa
ac
ag
an
aB
aM
ag
bi
bx
bP
aj
aa
aa
cA
cr
cN
aa
Me
aa
dl
"}
(10,1,1) = {"
aa
ac
ag
ag
ag
ag
ag
bi
bx
bQ
Me
bV
aa
aa
Me
cA
aa
cL
dh
aa
"}
(11,1,1) = {"
aa
ac
ag
ao
aC
ao
ag
bl
bz
bR
bR
Me
aj
aa
aj
Me
bR
bQ
di
aa
"}
(12,1,1) = {"
aa
ac
ah
ap
ap
ap
aW
bj
bA
bS
bW
Me
ax
aH
aH
aH
cX
dc
dj
aa
"}
(13,1,1) = {"
aa
ac
ag
ao
ao
ao
ag
bm
bB
bT
bX
ch
cu
cD
cL
cP
aJ
dd
ac
aa
"}
(14,1,1) = {"
aa
ac
ag
ag
ag
ag
ag
bn
bC
bU
bY
ci
cv
cB
bU
cQ
cQ
bU
ac
aa
"}
(15,1,1) = {"
aa
ad
ai
aq
aD
ct
aX
bo
bp
bU
aa
cj
bU
cF
bU
Me
aa
bU
ac
aa
"}
(16,1,1) = {"
aa
aa
aa
ar
ar
ar
aY
bp
bp
bU
bZ
ck
bU
cC
bU
bZ
bZ
bU
ac
aa
"}
(17,1,1) = {"
aa
aa
aa
as
aE
aN
aZ
bq
bD
bU
ca
cl
cw
cn
cM
cR
cY
bU
ac
aa
"}
(18,1,1) = {"
aa
aa
aa
ar
ar
ar
ba
bp
bE
bU
cb
cm
cn
cx
cn
cm
cZ
de
dk
aa
"}
(19,1,1) = {"
aa
aa
aa
at
aF
aO
aZ
bq
bD
bU
cc
cn
cx
cH
cn
cn
da
df
ac
aa
"}
(20,1,1) = {"
aa
aa
aa
ar
ar
ar
bb
bp
bp
bU
cd
co
cn
cI
cn
cS
cG
df
ac
aa
"}
(21,1,1) = {"
aa
aa
aa
au
aE
aP
aZ
bq
bD
bU
ce
cn
cn
cn
cn
cn
cG
df
ac
aa
"}
(22,1,1) = {"
aa
aa
aa
ar
ar
ar
bc
bp
bE
bU
cf
cn
cn
cJ
cn
cT
cn
dg
dk
aa
"}
(23,1,1) = {"
aa
aa
aa
av
aE
aQ
bd
bq
bF
bU
cg
cp
cy
cE
cE
cU
db
bU
ac
aa
"}
(24,1,1) = {"
aa
aa
aa
ar
ar
ar
ar
bp
bG
bU
bU
cq
cz
cz
cz
cV
bU
bU
ac
aa
"}
(25,1,1) = {"
aa
aa
aa
aa
aw
aa
ar
br
ar
ar
Me
ad
ai
ai
ai
cW
ai
ai
af
aa
"}
(26,1,1) = {"
aa
aa
aa
aa
ar
ar
ar
bs
bH
ar
aa
aa
aa
aa
aa
aa
aa
aa
aa
aa
"}
(27,1,1) = {"
aa
aa
aa
aa
aG
aR
be
bt
bI
be
aa
aa
aa
aa
aa
aa
aa
aa
aa
aa
"}
(28,1,1) = {"
aa
aa
aa
aa
ar
ar
ar
bu
bJ
ar
aa
aa
aa
aa
aa
aa
aa
aa
aa
aa
"}
(29,1,1) = {"
aa
aa
aa
aa
aa
aa
ar
be
be
ar
aa
aa
aa
aa
aa
aa
aa
aa
aa
aa
"}
