//MAP CONVERTED BY dmm2tgm.py THIS HEADER COMMENT PREVENTS RECONVERSION, DO NOT REMOVE
"a" = (
/turf/template_noop,
/area/template_noop)
"b" = (
/turf/closed/wall/mineral/titanium,
/area/external/shuttle/station/arrival)
"d" = (
/obj/machinery/holopad,
/turf/open/floor/mineral/titanium/white,
/area/external/shuttle/station/arrival)
"e" = (
/obj/item/storage/toolbox/emergency{
	pixel_y = 5
	},
/obj/item/storage/toolbox/emergency,
/obj/machinery/status_display/ai{
	pixel_x = -32
	},
/obj/structure/table/reinforced,
/turf/open/floor/mineral/titanium/blue,
/area/external/shuttle/station/arrival)
"f" = (
/turf/open/floor/mineral/titanium/blue,
/area/external/shuttle/station/arrival)
"g" = (
/obj/machinery/light{
	dir = 1
	},
/obj/machinery/vending/wallmed{
	name = "Emergency NanoMed";
	pixel_y = 32;
	use_power = 0
	},
/turf/open/floor/mineral/titanium/blue,
/area/external/shuttle/station/arrival)
"h" = (
/obj/machinery/door/airlock/titanium{
	name = "Arrivals Shuttle Airlock"
	},
/obj/machinery/door/firedoor/border_only{
	dir = 1
	},
/obj/machinery/door/firedoor/border_only,
/obj/effect/turf_decal/stripes/line,
/obj/effect/turf_decal/stripes/line{
	dir = 1
	},
/obj/structure/fans/tiny,
/turf/open/floor/plating,
/area/external/shuttle/station/arrival)
"i" = (
/obj/structure/closet/wardrobe/black,
/turf/open/floor/mineral/titanium/blue,
/area/external/shuttle/station/arrival)
"j" = (
/obj/structure/closet/wardrobe/mixed,
/turf/open/floor/mineral/titanium/blue,
/area/external/shuttle/station/arrival)
"k" = (
/obj/structure/closet/wardrobe/grey,
/turf/open/floor/mineral/titanium/blue,
/area/external/shuttle/station/arrival)
"l" = (
/obj/machinery/requests_console{
	department = "Arrival shuttle";
	name = "Arrivals Shuttle console";
	pixel_y = 30
	},
/obj/machinery/light{
	dir = 1
	},
/turf/open/floor/mineral/titanium/blue,
/area/external/shuttle/station/arrival)
"m" = (
/obj/structure/shuttle/engine/heater{
	dir = 4
	},
/obj/structure/window/reinforced{
	dir = 8
	},
/obj/effect/turf_decal/stripes/line{
	dir = 4
	},
/turf/open/floor/plating/airless,
/area/external/shuttle/station/arrival)
"n" = (
/obj/structure/shuttle/engine/propulsion/burst/right{
	dir = 4
	},
/obj/effect/turf_decal/stripes/line{
	dir = 4
	},
/turf/open/floor/plating/airless,
/area/external/shuttle/station/arrival)
"o" = (
/obj/effect/spawner/structure/window/shuttle,
/obj/machinery/door/firedoor/window,
/turf/open/floor/plating,
/area/external/shuttle/station/arrival)
"p" = (
/obj/structure/chair/comfy/shuttle,
/turf/open/floor/mineral/titanium/blue,
/area/external/shuttle/station/arrival)
"q" = (
/obj/structure/chair/comfy/shuttle,
/obj/machinery/light/small{
	dir = 4
	},
/turf/open/floor/mineral/titanium/blue,
/area/external/shuttle/station/arrival)
"r" = (
/obj/structure/chair/comfy/shuttle{
	dir = 8
	},
/turf/open/floor/mineral/titanium/white,
/area/external/shuttle/station/arrival)
"s" = (
/obj/structure/shuttle/engine/propulsion{
	dir = 4
	},
/obj/effect/turf_decal/stripes/line{
	dir = 4
	},
/turf/open/floor/plating/airless,
/area/external/shuttle/station/arrival)
"t" = (
/obj/machinery/door/airlock/titanium{
	name = "Arrivals Shuttle Airlock"
	},
/obj/machinery/door/firedoor/border_only{
	dir = 4
	},
/obj/machinery/door/firedoor/border_only{
	dir = 8
	},
/turf/open/floor/mineral/titanium/white,
/area/external/shuttle/station/arrival)
"u" = (
/obj/docking_port/mobile/arrivals,
/obj/effect/turf_decal/stripes/line{
	dir = 4
	},
/obj/structure/shuttle/engine/propulsion{
	dir = 4
	},
/turf/open/floor/plating/airless,
/area/external/shuttle/station/arrival)
"v" = (
/obj/structure/chair/comfy/shuttle{
	dir = 1
	},
/turf/open/floor/mineral/titanium/blue,
/area/external/shuttle/station/arrival)
"w" = (
/obj/structure/chair/comfy/shuttle{
	dir = 1
	},
/obj/machinery/light/small{
	dir = 4
	},
/turf/open/floor/mineral/titanium/blue,
/area/external/shuttle/station/arrival)
"x" = (
/obj/structure/closet/crate/internals,
/obj/item/storage/firstaid/o2,
/obj/item/tank/internals/emergency_oxygen,
/obj/item/tank/internals/emergency_oxygen,
/obj/item/tank/internals/emergency_oxygen,
/obj/item/tank/internals/emergency_oxygen,
/obj/item/clothing/mask/breath,
/obj/item/clothing/mask/breath,
/obj/item/clothing/mask/breath,
/obj/item/clothing/mask/breath,
/obj/item/tank/internals/emergency_oxygen,
/obj/item/clothing/mask/breath,
/obj/machinery/status_display/evac{
	pixel_x = -32
	},
/turf/open/floor/mineral/titanium/blue,
/area/external/shuttle/station/arrival)
"y" = (
/obj/machinery/light,
/obj/structure/extinguisher_cabinet{
	pixel_y = -29
	},
/turf/open/floor/mineral/titanium/blue,
/area/external/shuttle/station/arrival)
"z" = (
/obj/item/radio/intercom{
	name = "Station Intercom (General)";
	pixel_y = -29
	},
/obj/machinery/light,
/turf/open/floor/mineral/titanium/blue,
/area/external/shuttle/station/arrival)
"A" = (
/obj/structure/shuttle/engine/propulsion/burst/left{
	dir = 4
	},
/obj/effect/turf_decal/stripes/line{
	dir = 4
	},
/turf/open/floor/plating/airless,
/area/external/shuttle/station/arrival)
"H" = (
/obj/structure/sign/nanotrasen,
/turf/closed/wall/mineral/titanium,
/area/external/shuttle/station/arrival)
"N" = (
/obj/structure/window/reinforced{
	dir = 8
	},
/obj/effect/turf_decal/stripes/line{
	dir = 4
	},
/obj/structure/shuttle/engine/heater{
	dir = 4
	},
/turf/open/floor/plating/airless,
/area/external/shuttle/station/arrival)
"Q" = (
/turf/closed/wall/mineral/titanium/nodiagonal,
/area/external/shuttle/station/arrival)
"S" = (
/turf/open/floor/mineral/titanium/white,
/area/external/shuttle/station/arrival)
"U" = (
/obj/structure/closet/wardrobe/white,
/turf/open/floor/mineral/titanium/blue,
/area/external/shuttle/station/arrival)
"V" = (
/obj/structure/sign/poster/official/random,
/turf/closed/wall/mineral/titanium,
/area/external/shuttle/station/arrival)

(1,1,1) = {"
a
b
o
o
o
b
a
"}
(2,1,1) = {"
a
b
p
S
v
b
a
"}
(3,1,1) = {"
a
b
q
S
w
b
a
"}
(4,1,1) = {"
b
b
V
t
V
b
b
"}
(5,1,1) = {"
H
e
S
S
S
x
H
"}
(6,1,1) = {"
h
f
r
r
r
f
h
"}
(7,1,1) = {"
b
g
f
f
f
y
b
"}
(8,1,1) = {"
o
i
r
r
r
f
o
"}
(9,1,1) = {"
o
k
f
d
f
f
o
"}
(10,1,1) = {"
o
j
r
r
r
f
o
"}
(11,1,1) = {"
o
U
f
f
f
f
o
"}
(12,1,1) = {"
b
l
r
r
r
z
b
"}
(13,1,1) = {"
h
f
S
S
S
f
h
"}
(14,1,1) = {"
b
m
m
N
m
m
b
"}
(15,1,1) = {"
Q
n
s
u
s
A
Q
"}
