//MAP CONVERTED BY dmm2tgm.py THIS HEADER COMMENT PREVENTS RECONVERSION, DO NOT REMOVE
"a" = (
/turf/closed/wall/mineral/plastitanium,
/area/external/shuttle/station/arrival)
"b" = (
/turf/closed/wall/mineral/titanium/nodiagonal,
/area/external/shuttle/station/arrival)
"c" = (
/turf/closed/wall/mineral/titanium,
/area/external/shuttle/station/arrival)
"d" = (
/obj/machinery/door/airlock/shuttle{
	name = "Arrival Shuttle Airlock"
	},
/obj/effect/turf_decal/stripes/line,
/obj/effect/turf_decal/stripes/line{
	dir = 1
	},
/obj/machinery/door/firedoor/border_only{
	dir = 1
	},
/obj/machinery/door/firedoor/border_only,
/obj/structure/fans/tiny,
/turf/open/floor/mineral/plastitanium,
/area/external/shuttle/station/arrival)
"e" = (
/obj/structure/sign/nanotrasen,
/turf/closed/wall/mineral/titanium,
/area/external/shuttle/station/arrival)
"g" = (
/turf/template_noop,
/area/template_noop)
"h" = (
/obj/structure/sign/warning/fire,
/turf/closed/wall/mineral/titanium,
/area/external/shuttle/station/arrival)
"i" = (
/obj/item/clothing/suit/hazardvest{
	desc = "A high-visibility lifejacket complete with whistle and slot for oxygen tanks.";
	name = "emergency lifejacket"
	},
/obj/item/clothing/suit/hazardvest{
	desc = "A high-visibility lifejacket complete with whistle and slot for oxygen tanks.";
	name = "emergency lifejacket"
	},
/obj/item/tank/internals/emergency_oxygen{
	pixel_x = 3
	},
/obj/item/tank/internals/emergency_oxygen{
	pixel_x = 3
	},
/obj/item/clothing/mask/breath{
	pixel_x = -3;
	pixel_y = -3
	},
/obj/item/clothing/mask/breath{
	pixel_x = -3;
	pixel_y = -3
	},
/obj/item/clothing/head/hardhat/orange{
	name = "protective hat";
	pixel_y = 9
	},
/obj/item/clothing/head/hardhat/orange{
	name = "protective hat";
	pixel_y = 9
	},
/obj/structure/closet/crate/internals,
/obj/effect/turf_decal/delivery,
/turf/open/floor/mineral/plastitanium,
/area/external/shuttle/station/arrival)
"j" = (
/obj/effect/turf_decal/tile/blue{
	dir = 1
	},
/obj/effect/turf_decal/tile/blue,
/obj/effect/turf_decal/arrows{
	dir = 1;
	icon_state = "arrows"
	},
/obj/effect/turf_decal/stripes/line{
	dir = 8
	},
/obj/effect/turf_decal/stripes/line{
	dir = 4
	},
/turf/open/floor/mineral/titanium/white,
/area/external/shuttle/station/arrival)
"k" = (
/obj/effect/turf_decal/bot,
/obj/structure/chair/comfy/shuttle,
/turf/open/floor/mineral/plastitanium,
/area/external/shuttle/station/arrival)
"l" = (
/obj/effect/turf_decal/bot,
/obj/structure/chair/comfy/shuttle,
/obj/machinery/status_display/evac{
	pixel_y = 32
	},
/obj/machinery/light{
	dir = 1
	},
/turf/open/floor/mineral/plastitanium,
/area/external/shuttle/station/arrival)
"m" = (
/obj/effect/turf_decal/tile/blue{
	dir = 1
	},
/obj/effect/turf_decal/tile/blue,
/obj/effect/turf_decal/arrows{
	dir = 1;
	icon_state = "arrows"
	},
/obj/effect/turf_decal/stripes/line{
	dir = 8
	},
/turf/open/floor/mineral/titanium/white,
/area/external/shuttle/station/arrival)
"n" = (
/obj/structure/shuttle/engine/propulsion/left{
	dir = 8;
	icon_state = "propulsion_l"
	},
/obj/effect/turf_decal/stripes/line{
	dir = 8
	},
/turf/open/floor/plating/airless,
/area/external/shuttle/station/arrival)
"p" = (
/obj/structure/table,
/obj/item/flashlight{
	pixel_y = 8
	},
/obj/item/flashlight,
/turf/open/floor/mineral/plastitanium,
/area/external/shuttle/station/arrival)
"q" = (
/obj/effect/turf_decal/tile/blue{
	dir = 1
	},
/obj/effect/turf_decal/tile/blue,
/obj/effect/turf_decal/arrows{
	dir = 1;
	icon_state = "arrows"
	},
/obj/effect/turf_decal/stripes/line{
	dir = 8
	},
/obj/effect/turf_decal/stripes/corner{
	dir = 4
	},
/turf/open/floor/mineral/titanium/white,
/area/external/shuttle/station/arrival)
"r" = (
/obj/effect/turf_decal/tile/blue{
	dir = 1
	},
/obj/effect/turf_decal/tile/blue,
/obj/effect/turf_decal/stripes/line{
	dir = 1
	},
/turf/open/floor/mineral/titanium/white,
/area/external/shuttle/station/arrival)
"s" = (
/obj/effect/turf_decal/tile/blue{
	dir = 1
	},
/obj/effect/turf_decal/tile/blue,
/obj/item/radio/intercom{
	pixel_x = 28
	},
/obj/effect/turf_decal/arrows{
	dir = 1;
	icon_state = "arrows"
	},
/obj/effect/turf_decal/stripes/corner,
/obj/effect/turf_decal/stripes/corner{
	dir = 1
	},
/turf/open/floor/mineral/titanium/white,
/area/external/shuttle/station/arrival)
"t" = (
/obj/effect/turf_decal/bot,
/obj/effect/turf_decal/stripes/corner{
	dir = 8
	},
/obj/structure/chair/comfy/shuttle,
/obj/machinery/light/small{
	dir = 8
	},
/turf/open/floor/mineral/plastitanium,
/area/external/shuttle/station/arrival)
"u" = (
/obj/structure/shuttle/engine/propulsion{
	dir = 8;
	icon_state = "propulsion"
	},
/obj/effect/turf_decal/stripes/line{
	dir = 8
	},
/obj/docking_port/mobile/arrivals{
	dir = 4;
	name = "kilo arrivals shuttle"
	},
/turf/open/floor/plating/airless,
/area/external/shuttle/station/arrival)
"v" = (
/obj/structure/rack,
/obj/effect/turf_decal/bot,
/obj/effect/turf_decal/tile/neutral{
	dir = 1
	},
/obj/effect/turf_decal/tile/neutral{
	dir = 4
	},
/obj/item/radio{
	pixel_x = -6;
	pixel_y = 6
	},
/obj/item/radio{
	pixel_x = 6;
	pixel_y = 6
	},
/obj/item/radio{
	pixel_y = 4
	},
/turf/open/floor/mineral/plastitanium,
/area/external/shuttle/station/arrival)
"w" = (
/obj/effect/turf_decal/tile/blue{
	dir = 1
	},
/obj/effect/turf_decal/tile/blue,
/obj/effect/turf_decal/stripes/line{
	dir = 8
	},
/turf/open/floor/mineral/titanium/white,
/area/external/shuttle/station/arrival)
"x" = (
/obj/effect/turf_decal/tile/blue{
	dir = 1
	},
/obj/effect/turf_decal/tile/blue,
/turf/open/floor/mineral/titanium/white,
/area/external/shuttle/station/arrival)
"y" = (
/obj/machinery/requests_console{
	department = "Arrival shuttle";
	name = "Arrivals Shuttle console"
	},
/turf/closed/wall/mineral/titanium/nodiagonal,
/area/external/shuttle/station/arrival)
"z" = (
/obj/structure/flora/ausbushes/grassybush,
/obj/structure/flora/ausbushes/lavendergrass,
/obj/structure/flora/ausbushes/ywflowers,
/obj/structure/flora/ausbushes/fernybush,
/obj/structure/window/shuttle,
/turf/open/floor/grass,
/area/external/shuttle/station/arrival)
"A" = (
/obj/machinery/vending/wallmed{
	name = "Emergency NanoMed";
	use_power = 0
	},
/turf/closed/wall/mineral/titanium/nodiagonal,
/area/external/shuttle/station/arrival)
"C" = (
/obj/effect/turf_decal/tile/blue{
	dir = 1
	},
/obj/effect/turf_decal/tile/blue,
/obj/effect/turf_decal/stripes/line{
	dir = 4
	},
/turf/open/floor/mineral/titanium/white,
/area/external/shuttle/station/arrival)
"E" = (
/obj/effect/turf_decal/tile/blue,
/obj/effect/turf_decal/tile/blue{
	dir = 1
	},
/obj/effect/turf_decal/stripes/line{
	dir = 8
	},
/turf/open/floor/mineral/titanium/white,
/area/external/shuttle/station/arrival)
"F" = (
/obj/effect/turf_decal/tile/blue,
/obj/effect/turf_decal/tile/blue{
	dir = 1
	},
/turf/open/floor/mineral/titanium/white,
/area/external/shuttle/station/arrival)
"G" = (
/obj/structure/shuttle/engine/propulsion/right{
	dir = 8;
	icon_state = "propulsion_r"
	},
/obj/effect/turf_decal/stripes/line{
	dir = 8
	},
/turf/open/floor/plating/airless,
/area/external/shuttle/station/arrival)
"H" = (
/obj/structure/table,
/obj/item/storage/toolbox/emergency,
/obj/item/crowbar/red,
/turf/open/floor/mineral/plastitanium,
/area/external/shuttle/station/arrival)
"I" = (
/obj/effect/turf_decal/tile/blue{
	dir = 1
	},
/obj/effect/turf_decal/tile/blue,
/obj/effect/turf_decal/stripes/line{
	dir = 8
	},
/obj/effect/turf_decal/stripes/corner,
/turf/open/floor/mineral/titanium/white,
/area/external/shuttle/station/arrival)
"J" = (
/obj/effect/turf_decal/tile/blue{
	dir = 1
	},
/obj/effect/turf_decal/tile/blue,
/obj/effect/turf_decal/stripes/line,
/turf/open/floor/mineral/titanium/white,
/area/external/shuttle/station/arrival)
"K" = (
/obj/effect/turf_decal/tile/blue{
	dir = 1
	},
/obj/effect/turf_decal/tile/blue,
/obj/effect/turf_decal/stripes/corner{
	dir = 4
	},
/obj/effect/turf_decal/stripes/corner{
	dir = 8
	},
/turf/open/floor/mineral/titanium/white,
/area/external/shuttle/station/arrival)
"L" = (
/obj/machinery/status_display/ai,
/turf/closed/wall/mineral/titanium,
/area/external/shuttle/station/arrival)
"M" = (
/obj/effect/turf_decal/bot,
/obj/effect/turf_decal/stripes/corner{
	dir = 1
	},
/obj/structure/chair/comfy/shuttle{
	dir = 1
	},
/obj/machinery/light/small{
	dir = 8
	},
/turf/open/floor/mineral/plastitanium,
/area/external/shuttle/station/arrival)
"N" = (
/obj/effect/turf_decal/bot,
/obj/structure/chair/comfy/shuttle{
	dir = 1
	},
/turf/open/floor/mineral/plastitanium,
/area/external/shuttle/station/arrival)
"O" = (
/obj/effect/turf_decal/tile/blue{
	dir = 1
	},
/obj/effect/turf_decal/tile/blue,
/obj/effect/turf_decal/stripes/line{
	dir = 8
	},
/obj/effect/turf_decal/stripes/line{
	dir = 4
	},
/turf/open/floor/mineral/titanium/white,
/area/external/shuttle/station/arrival)
"P" = (
/obj/effect/turf_decal/bot,
/obj/structure/chair/comfy/shuttle{
	dir = 1
	},
/obj/machinery/status_display/evac{
	pixel_y = -32
	},
/obj/machinery/light,
/turf/open/floor/mineral/plastitanium,
/area/external/shuttle/station/arrival)
"R" = (
/obj/structure/shuttle/engine/heater{
	dir = 8;
	icon_state = "heater"
	},
/obj/effect/spawner/structure/window/shuttle,
/obj/machinery/door/firedoor/window,
/turf/open/floor/plating,
/area/external/shuttle/station/arrival)
"S" = (
/obj/effect/turf_decal/bot,
/obj/structure/chair/comfy/shuttle{
	dir = 1
	},
/obj/machinery/light,
/turf/open/floor/mineral/plastitanium,
/area/external/shuttle/station/arrival)
"W" = (
/obj/effect/spawner/structure/window/shuttle,
/obj/machinery/door/firedoor/window,
/turf/open/floor/plating,
/area/external/shuttle/station/arrival)
"Y" = (
/obj/effect/turf_decal/stripes/line{
	dir = 2
	},
/obj/machinery/door/airlock/shuttle{
	name = "Arrival Shuttle Airlock"
	},
/obj/effect/turf_decal/stripes/line{
	dir = 1
	},
/obj/effect/turf_decal/delivery,
/obj/machinery/door/firedoor/border_only{
	dir = 8
	},
/obj/machinery/door/firedoor/border_only{
	dir = 4
	},
/turf/open/floor/mineral/plastitanium,
/area/external/shuttle/station/arrival)
"Z" = (
/obj/effect/turf_decal/bot,
/obj/structure/chair/comfy/shuttle,
/obj/machinery/light{
	dir = 1
	},
/turf/open/floor/mineral/plastitanium,
/area/external/shuttle/station/arrival)

(1,1,1) = {"
a
a
n
u
G
a
a
"}
(2,1,1) = {"
b
h
R
R
R
h
b
"}
(3,1,1) = {"
c
i
p
v
H
i
c
"}
(4,1,1) = {"
d
j
q
w
I
O
W
"}
(5,1,1) = {"
e
Z
r
x
J
S
e
"}
(6,1,1) = {"
W
k
r
y
J
N
W
"}
(7,1,1) = {"
W
k
r
z
J
N
W
"}
(8,1,1) = {"
W
k
r
A
J
N
W
"}
(9,1,1) = {"
c
l
r
x
J
P
c
"}
(10,1,1) = {"
d
m
s
C
K
w
W
"}
(11,1,1) = {"
b
c
c
Y
L
c
b
"}
(12,1,1) = {"
c
e
t
E
M
e
c
"}
(13,1,1) = {"
g
c
k
F
N
c
g
"}
(14,1,1) = {"
g
c
W
W
W
c
g
"}
