//MAP CONVERTED BY dmm2tgm.py THIS HEADER COMMENT PREVENTS RECONVERSION, DO NOT REMOVE
"aa" = (
/turf/template_noop,
/area/template_noop)
"ab" = (
/turf/closed/wall/mineral/titanium,
/area/external/shuttle/station/escape)
"ac" = (
/obj/effect/spawner/structure/window/shuttle,
/turf/open/floor/plating,
/area/external/shuttle/station/escape)
"ad" = (
/turf/closed/wall/mineral/titanium/nodiagonal,
/area/external/shuttle/station/escape)
"ae" = (
/obj/structure/table,
/obj/item/phone{
	pixel_x = -3;
	pixel_y = 3
	},
/obj/machinery/light{
	dir = 8
	},
/turf/open/floor/mineral/titanium/blue,
/area/external/shuttle/station/escape)
"af" = (
/obj/machinery/computer/station_alert,
/turf/open/floor/mineral/titanium/blue,
/area/external/shuttle/station/escape)
"ag" = (
/obj/machinery/computer/emergency_shuttle,
/turf/open/floor/mineral/titanium/blue,
/area/external/shuttle/station/escape)
"ah" = (
/obj/machinery/computer/communications/unlocked,
/turf/open/floor/mineral/titanium/blue,
/area/external/shuttle/station/escape)
"ai" = (
/obj/machinery/computer/crew,
/turf/open/floor/mineral/titanium/blue,
/area/external/shuttle/station/escape)
"aj" = (
/obj/structure/table,
/obj/item/storage/firstaid/regular,
/obj/machinery/light{
	dir = 4
	},
/turf/open/floor/mineral/titanium/blue,
/area/external/shuttle/station/escape)
"ak" = (
/turf/open/floor/mineral/titanium/blue,
/area/external/shuttle/station/escape)
"al" = (
/obj/structure/chair/comfy/shuttle{
	dir = 1
	},
/turf/open/floor/mineral/titanium/blue,
/area/external/shuttle/station/escape)
"am" = (
/turf/open/floor/mineral/titanium,
/area/external/shuttle/station/escape)
"an" = (
/obj/structure/table,
/obj/item/restraints/handcuffs{
	pixel_y = 3
	},
/turf/open/floor/mineral/titanium/blue,
/area/external/shuttle/station/escape)
"ao" = (
/obj/machinery/button/flasher{
	id = "cockpit_flasher";
	pixel_x = 6;
	pixel_y = -24
	},
/turf/open/floor/mineral/titanium,
/area/external/shuttle/station/escape)
"ap" = (
/obj/structure/table,
/obj/item/paper_bin,
/obj/item/pen,
/turf/open/floor/mineral/titanium/blue,
/area/external/shuttle/station/escape)
"aq" = (
/obj/structure/table,
/turf/open/floor/mineral/titanium/blue,
/area/external/shuttle/station/escape)
"ar" = (
/obj/structure/table,
/obj/item/storage/toolbox/mechanical,
/obj/item/crowbar,
/turf/open/floor/mineral/titanium/blue,
/area/external/shuttle/station/escape)
"as" = (
/obj/structure/table,
/obj/item/storage/fancy/donut_box,
/turf/open/floor/mineral/titanium/blue,
/area/external/shuttle/station/escape)
"at" = (
/obj/structure/table,
/obj/machinery/recharger{
	active_power_usage = 0;
	idle_power_usage = 0;
	pixel_y = 4;
	use_power = 0
	},
/turf/open/floor/mineral/titanium/blue,
/area/external/shuttle/station/escape)
"au" = (
/obj/machinery/door/airlock/command/glass{
	name = "Cockpit"
	},
/obj/machinery/door/firedoor/border_only{
	dir = 1
	},
/obj/machinery/door/firedoor/border_only,
/obj/effect/mapping_helpers/airlock/access/all/command/general,
/turf/open/floor/mineral/titanium,
/area/external/shuttle/station/escape)
"av" = (
/obj/machinery/status_display/evac,
/turf/closed/wall/mineral/titanium,
/area/external/shuttle/station/escape)
"aw" = (
/obj/machinery/flasher{
	id = "cockpit_flasher";
	pixel_x = 6;
	pixel_y = 24
	},
/turf/open/floor/mineral/titanium/blue,
/area/external/shuttle/station/escape)
"ax" = (
/obj/structure/closet/emcloset,
/turf/open/floor/mineral/titanium/blue,
/area/external/shuttle/station/escape)
"ay" = (
/obj/structure/chair/comfy/shuttle{
	dir = 4
	},
/turf/open/floor/mineral/plastitanium/red/brig,
/area/external/shuttle/station/escape)
"az" = (
/obj/machinery/button/flasher{
	id = "shuttle_flasher";
	pixel_x = 8;
	pixel_y = 24
	},
/turf/open/floor/mineral/plastitanium/red/brig,
/area/external/shuttle/station/escape)
"aA" = (
/obj/structure/chair,
/turf/open/floor/mineral/plastitanium/red/brig,
/area/external/shuttle/station/escape)
"aB" = (
/obj/structure/chair,
/obj/machinery/flasher{
	id = "shuttle_flasher";
	pixel_x = -6;
	pixel_y = 24
	},
/turf/open/floor/mineral/plastitanium/red/brig,
/area/external/shuttle/station/escape)
"aC" = (
/turf/open/floor/mineral/plastitanium/red/brig,
/area/external/shuttle/station/escape)
"aD" = (
/obj/machinery/door/airlock/public/glass{
	name = "Containment Cell"
	},
/obj/machinery/door/firedoor/border_only{
	dir = 4
	},
/obj/machinery/door/firedoor/border_only{
	dir = 8
	},
/obj/effect/mapping_helpers/airlock/access/all/security/general,
/turf/open/floor/mineral/plastitanium/red/brig,
/area/external/shuttle/station/escape)
"aE" = (
/obj/machinery/light{
	dir = 4
	},
/turf/open/floor/mineral/plastitanium/red/brig,
/area/external/shuttle/station/escape)
"aF" = (
/obj/structure/chair{
	dir = 1
	},
/turf/open/floor/mineral/plastitanium/red/brig,
/area/external/shuttle/station/escape)
"aG" = (
/obj/structure/chair/comfy/shuttle{
	dir = 4
	},
/obj/machinery/light{
	dir = 8
	},
/turf/open/floor/mineral/plastitanium/red/brig,
/area/external/shuttle/station/escape)
"aH" = (
/obj/machinery/status_display/evac,
/turf/closed/wall/mineral/titanium/nodiagonal,
/area/external/shuttle/station/escape)
"aI" = (
/obj/structure/table,
/obj/item/storage/fancy/donut_box,
/obj/item/book/manual/wiki/security_space_law,
/obj/item/storage/box/handcuffs,
/turf/open/floor/mineral/plastitanium/red/brig,
/area/external/shuttle/station/escape)
"aJ" = (
/obj/machinery/light,
/turf/open/floor/mineral/titanium,
/area/external/shuttle/station/escape)
"aK" = (
/obj/structure/table,
/obj/machinery/recharger,
/obj/structure/reagent_dispensers/peppertank{
	pixel_y = 32
	},
/turf/open/floor/mineral/plastitanium/red/brig,
/area/external/shuttle/station/escape)
"aL" = (
/obj/machinery/door/airlock/public/glass{
	name = "Emergency Shuttle Brig"
	},
/obj/machinery/door/firedoor/border_only{
	dir = 4
	},
/obj/machinery/door/firedoor/border_only{
	dir = 8
	},
/obj/effect/mapping_helpers/airlock/access/all/security/basic,
/turf/open/floor/mineral/titanium,
/area/external/shuttle/station/escape)
"aM" = (
/obj/structure/chair/comfy/shuttle{
	dir = 8
	},
/turf/open/floor/mineral/titanium/blue,
/area/external/shuttle/station/escape)
"aN" = (
/obj/machinery/vending/wallmed{
	name = "Emergency NanoMed";
	use_power = 0
	},
/turf/closed/wall/mineral/titanium,
/area/external/shuttle/station/escape)
"aO" = (
/obj/structure/chair/comfy/shuttle{
	dir = 4
	},
/turf/open/floor/mineral/titanium/blue,
/area/external/shuttle/station/escape)
"aP" = (
/obj/machinery/door/airlock/titanium{
	name = "Emergency Shuttle Airlock"
	},
/obj/machinery/door/firedoor/border_only{
	dir = 4
	},
/obj/machinery/door/firedoor/border_only{
	dir = 8
	},
/obj/effect/mapping_helpers/airlock/access/all/security/basic,
/turf/open/floor/plating,
/area/external/shuttle/station/escape)
"aQ" = (
/obj/structure/chair/comfy/shuttle{
	dir = 1
	},
/turf/open/floor/mineral/plastitanium/red/brig,
/area/external/shuttle/station/escape)
"aR" = (
/obj/machinery/door/airlock/titanium{
	name = "Emergency Shuttle Airlock"
	},
/obj/machinery/door/firedoor/border_only{
	dir = 4
	},
/obj/machinery/door/firedoor/border_only{
	dir = 8
	},
/turf/open/floor/plating,
/area/external/shuttle/station/escape)
"aS" = (
/obj/machinery/door/airlock/titanium{
	name = "Emergency Shuttle Airlock"
	},
/obj/docking_port/mobile/emergency{
	name = "Donut emergency shuttle";
	width = 34
	},
/obj/machinery/door/firedoor/border_only{
	dir = 4
	},
/obj/machinery/door/firedoor/border_only{
	dir = 8
	},
/turf/open/floor/plating,
/area/external/shuttle/station/escape)
"aT" = (
/obj/structure/extinguisher_cabinet,
/turf/closed/wall/mineral/titanium,
/area/external/shuttle/station/escape)
"aU" = (
/obj/machinery/light,
/obj/machinery/light{
	dir = 1
	},
/turf/open/floor/mineral/titanium,
/area/external/shuttle/station/escape)
"aV" = (
/obj/machinery/door/firedoor/border_only,
/turf/open/floor/mineral/titanium/blue,
/area/external/shuttle/station/escape)
"aW" = (
/obj/structure/chair/comfy/shuttle{
	dir = 1
	},
/obj/structure/window/reinforced,
/turf/open/floor/mineral/titanium/blue,
/area/external/shuttle/station/escape)
"aX" = (
/obj/structure/chair/comfy/shuttle,
/obj/structure/window/reinforced{
	dir = 1
	},
/turf/open/floor/mineral/titanium/blue,
/area/external/shuttle/station/escape)
"aY" = (
/obj/machinery/door/firedoor/border_only,
/turf/open/floor/mineral/titanium,
/area/external/shuttle/station/escape)
"aZ" = (
/obj/machinery/holopad,
/turf/open/floor/mineral/titanium,
/area/external/shuttle/station/escape)
"ba" = (
/obj/structure/reagent_dispensers/fueltank,
/obj/effect/turf_decal/bot,
/turf/open/floor/plasteel,
/area/external/shuttle/station/escape)
"bb" = (
/turf/open/floor/mineral/titanium/yellow,
/area/external/shuttle/station/escape)
"bc" = (
/obj/machinery/door/airlock/public/glass{
	name = "Emergency Shuttle Infirmary"
	},
/obj/machinery/door/firedoor/border_only{
	dir = 1
	},
/obj/machinery/door/firedoor/border_only,
/turf/open/floor/mineral/titanium/white,
/area/external/shuttle/station/escape)
"bd" = (
/obj/structure/tank_dispenser/oxygen,
/obj/effect/turf_decal/bot,
/turf/open/floor/plasteel,
/area/external/shuttle/station/escape)
"be" = (
/obj/structure/reagent_dispensers/watertank,
/obj/effect/turf_decal/bot,
/turf/open/floor/plasteel,
/area/external/shuttle/station/escape)
"bf" = (
/obj/machinery/stasis,
/turf/open/floor/mineral/titanium,
/area/external/shuttle/station/escape)
"bg" = (
/turf/open/floor/mineral/titanium/white,
/area/external/shuttle/station/escape)
"bh" = (
/obj/structure/closet/crate{
	name = "emergency supplies crate"
	},
/obj/item/storage/toolbox/emergency,
/obj/item/storage/toolbox/emergency,
/obj/item/flashlight/flare/signal{
	pixel_x = 3;
	pixel_y = 3
	},
/obj/item/flashlight/flare/signal{
	pixel_x = -6;
	pixel_y = -2
	},
/obj/item/crowbar,
/obj/item/wrench,
/obj/item/radio,
/obj/effect/turf_decal/bot,
/turf/open/floor/plasteel,
/area/external/shuttle/station/escape)
"bi" = (
/obj/machinery/light,
/obj/machinery/portable_atmospherics/canister/oxygen,
/obj/effect/turf_decal/bot,
/turf/open/floor/plasteel,
/area/external/shuttle/station/escape)
"bj" = (
/obj/structure/sink{
	dir = 8;
	pixel_x = -12
	},
/turf/open/floor/mineral/titanium/white,
/area/external/shuttle/station/escape)
"bk" = (
/obj/machinery/shower{
	dir = 8
	},
/turf/open/floor/mineral/titanium/white,
/area/external/shuttle/station/escape)
"bl" = (
/obj/structure/closet/crate/medical{
	name = "medical crate"
	},
/obj/item/storage/firstaid/regular,
/obj/item/storage/firstaid/o2{
	pixel_x = 3;
	pixel_y = 3
	},
/obj/item/storage/firstaid/toxin{
	pixel_x = -4;
	pixel_y = 3
	},
/obj/item/healthanalyzer{
	pixel_x = 3;
	pixel_y = 3
	},
/obj/item/lazarus_injector,
/obj/effect/turf_decal/bot,
/obj/machinery/light,
/mob/living/simple_animal/bot/medbot{
	name = "\improper emergency medibot";
	pixel_x = -3;
	pixel_y = 2
	},
/turf/open/floor/plasteel,
/area/external/shuttle/station/escape)
"bm" = (
/obj/structure/closet/emcloset,
/obj/effect/turf_decal/stripes/line{
	dir = 1
	},
/turf/open/floor/plasteel,
/area/external/shuttle/station/escape)
"bn" = (
/obj/structure/table,
/obj/item/reagent_containers/glass/bottle/epinephrine{
	pixel_x = 6
	},
/obj/item/reagent_containers/glass/bottle/charcoal{
	pixel_x = -3
	},
/obj/item/reagent_containers/glass/bottle/epinephrine{
	pixel_x = -3;
	pixel_y = 8
	},
/obj/item/reagent_containers/glass/bottle/charcoal{
	pixel_x = 6;
	pixel_y = 8
	},
/obj/item/reagent_containers/syringe/epinephrine{
	pixel_x = 3;
	pixel_y = -2
	},
/obj/item/reagent_containers/syringe/epinephrine{
	pixel_x = 4;
	pixel_y = 1
	},
/obj/item/reagent_containers/syringe/epinephrine{
	pixel_x = -2;
	pixel_y = 5
	},
/obj/item/reagent_containers/syringe/epinephrine{
	pixel_x = 2;
	pixel_y = 8
	},
/obj/machinery/light,
/turf/open/floor/mineral/titanium,
/area/external/shuttle/station/escape)
"bo" = (
/obj/structure/table,
/obj/item/storage/firstaid/fire,
/obj/item/storage/firstaid/regular{
	pixel_x = 2;
	pixel_y = 3
	},
/turf/open/floor/mineral/titanium,
/area/external/shuttle/station/escape)
"bp" = (
/obj/structure/table,
/obj/item/storage/firstaid/toxin,
/obj/item/storage/firstaid/o2{
	pixel_x = 3;
	pixel_y = 3
	},
/turf/open/floor/mineral/titanium,
/area/external/shuttle/station/escape)
"bq" = (
/obj/structure/table,
/obj/item/defibrillator/loaded,
/obj/machinery/light,
/turf/open/floor/mineral/titanium,
/area/external/shuttle/station/escape)
"br" = (
/obj/effect/turf_decal/stripes/line{
	dir = 1
	},
/obj/machinery/recharge_station,
/turf/open/floor/plasteel,
/area/external/shuttle/station/escape)
"bs" = (
/obj/structure/window/reinforced{
	dir = 1
	},
/obj/structure/shuttle/engine/heater,
/turf/open/floor/plating/airless,
/area/external/shuttle/station/escape)
"bt" = (
/obj/structure/shuttle/engine/propulsion,
/turf/open/floor/plating/airless,
/area/external/shuttle/station/escape)
"bu" = (
/obj/machinery/door/firedoor/border_only{
	dir = 8
	},
/turf/open/floor/mineral/titanium/blue,
/area/external/shuttle/station/escape)
"bv" = (
/obj/machinery/door/firedoor/border_only{
	dir = 8
	},
/turf/open/floor/mineral/titanium,
/area/external/shuttle/station/escape)
"bw" = (
/obj/machinery/light,
/obj/machinery/door/firedoor/border_only{
	dir = 8
	},
/turf/open/floor/mineral/titanium,
/area/external/shuttle/station/escape)
"bx" = (
/obj/structure/chair/comfy/shuttle{
	dir = 4
	},
/obj/machinery/door/firedoor/border_only{
	dir = 1
	},
/turf/open/floor/mineral/titanium/blue,
/area/external/shuttle/station/escape)
"by" = (
/obj/machinery/door/firedoor/border_only{
	dir = 1
	},
/turf/open/floor/mineral/titanium,
/area/external/shuttle/station/escape)
"bz" = (
/obj/structure/chair/comfy/shuttle{
	dir = 8
	},
/obj/machinery/door/firedoor/border_only{
	dir = 1
	},
/turf/open/floor/mineral/titanium/blue,
/area/external/shuttle/station/escape)
"bA" = (
/obj/structure/chair/comfy/shuttle{
	dir = 8
	},
/obj/machinery/door/firedoor/border_only,
/turf/open/floor/mineral/titanium/blue,
/area/external/shuttle/station/escape)
"bB" = (
/obj/machinery/light{
	dir = 1
	},
/obj/machinery/door/firedoor/border_only{
	dir = 8
	},
/turf/open/floor/mineral/titanium,
/area/external/shuttle/station/escape)
"bC" = (
/obj/machinery/light{
	dir = 1
	},
/obj/machinery/door/firedoor/border_only{
	dir = 4
	},
/turf/open/floor/mineral/titanium,
/area/external/shuttle/station/escape)
"bD" = (
/obj/structure/chair/comfy/shuttle{
	dir = 1
	},
/obj/structure/window/reinforced,
/obj/machinery/door/firedoor/border_only{
	dir = 8
	},
/turf/open/floor/mineral/titanium/blue,
/area/external/shuttle/station/escape)
"bE" = (
/obj/structure/chair/comfy/shuttle{
	dir = 1
	},
/obj/structure/window/reinforced,
/obj/machinery/door/firedoor/border_only{
	dir = 4
	},
/turf/open/floor/mineral/titanium/blue,
/area/external/shuttle/station/escape)
"bF" = (
/obj/structure/chair/comfy/shuttle,
/obj/structure/window/reinforced{
	dir = 1
	},
/obj/machinery/door/firedoor/border_only{
	dir = 8
	},
/turf/open/floor/mineral/titanium/blue,
/area/external/shuttle/station/escape)
"bG" = (
/obj/structure/chair/comfy/shuttle,
/obj/structure/window/reinforced{
	dir = 1
	},
/obj/machinery/door/firedoor/border_only{
	dir = 4
	},
/turf/open/floor/mineral/titanium/blue,
/area/external/shuttle/station/escape)
"bH" = (
/obj/structure/sign/departments/medbay/alt{
	pixel_y = -32
	},
/obj/machinery/door/firedoor/border_only{
	dir = 8
	},
/turf/open/floor/mineral/titanium,
/area/external/shuttle/station/escape)
"bI" = (
/obj/structure/sign/departments/medbay/alt{
	pixel_y = -32
	},
/obj/machinery/door/firedoor/border_only{
	dir = 4
	},
/turf/open/floor/mineral/titanium,
/area/external/shuttle/station/escape)
"bJ" = (
/obj/structure/chair/comfy/shuttle{
	dir = 4
	},
/obj/machinery/door/firedoor/border_only,
/turf/open/floor/mineral/titanium/blue,
/area/external/shuttle/station/escape)
"bS" = (
/obj/item/storage/backpack/duffelbag/med/surgery,
/obj/item/clothing/suit/apron/surgical,
/obj/item/clothing/mask/surgical,
/obj/structure/table/optable,
/turf/open/floor/mineral/titanium,
/area/external/shuttle/station/escape)
"rL" = (
/obj/effect/spawner/structure/window/shuttle,
/obj/machinery/door/firedoor/border_only{
	dir = 1
	},
/turf/open/floor/plating,
/area/external/shuttle/station/escape)
"sp" = (
/obj/effect/spawner/structure/window/shuttle,
/obj/machinery/door/firedoor/border_only{
	dir = 4
	},
/turf/open/floor/plating,
/area/external/shuttle/station/escape)
"ZL" = (
/obj/effect/spawner/structure/window/shuttle,
/obj/machinery/door/firedoor/border_only{
	dir = 8
	},
/turf/open/floor/plating,
/area/external/shuttle/station/escape)

(1,1,1) = {"
aa
aa
aa
aa
aa
aa
aa
aa
aa
aa
aa
ab
ab
aP
ab
aS
ab
aa
aa
aa
ab
aR
ZL
aR
ab
aa
ab
ab
ab
ab
ab
aa
aa
aa
"}
(2,1,1) = {"
aa
aa
aa
aa
aa
ab
ab
ab
ab
ab
ab
ad
aK
aC
ab
ak
ab
ZL
ZL
ZL
ad
ak
aV
ak
ad
ab
ad
ba
be
bi
ad
ab
ab
ab
"}
(3,1,1) = {"
aa
ab
ZL
ZL
ab
ab
ab
ay
ay
ay
aG
aC
aC
aC
ab
ak
am
am
by
am
am
am
aY
am
am
am
am
bb
bb
bb
bm
ab
bs
bt
"}
(4,1,1) = {"
ab
ad
ak
ak
an
ap
ab
az
aC
aC
aC
aC
aC
aQ
ab
ak
am
am
bz
aM
aM
aM
bA
am
am
am
am
aH
ac
ac
ab
ab
bs
bt
"}
(5,1,1) = {"
ab
ae
ak
am
am
aq
av
ac
aD
ac
ad
aI
aC
aQ
ab
bu
bv
bw
aN
ac
ab
ac
aT
bB
bD
bF
bH
ab
bS
bj
bn
ab
bs
bt
"}
(6,1,1) = {"
rL
af
al
am
am
ar
ab
aA
aC
aF
ab
ac
aL
ac
aH
ak
am
am
bx
aO
aO
aO
bJ
am
aW
aX
am
bc
bg
bg
bg
ab
bs
bt
"}
(7,1,1) = {"
rL
ag
al
am
am
as
ab
aB
aC
aF
ab
am
am
am
am
am
aZ
am
by
am
am
am
aY
am
aW
aX
am
ac
bf
bg
bo
ab
bs
bt
"}
(8,1,1) = {"
rL
ah
al
am
am
at
ab
aA
aE
aF
ab
am
am
am
am
am
am
am
by
am
am
am
aY
am
aW
aX
am
ac
bf
bg
bp
ab
bs
bt
"}
(9,1,1) = {"
rL
ai
al
am
am
ad
ab
ab
ab
ab
aH
am
aM
aM
aM
aM
aM
am
bz
aM
aM
aM
bA
am
aW
aX
am
bc
bg
bg
bg
ab
bs
bt
"}
(10,1,1) = {"
ab
aj
ak
am
ao
ad
aw
ak
ak
ak
aV
aJ
aN
ac
ab
ac
aT
aU
aN
ac
ab
ac
aT
bC
bE
bG
bI
ab
bf
bk
bq
ab
bs
bt
"}
(11,1,1) = {"
ab
ad
ak
ak
ak
au
am
am
am
am
aY
am
aO
aO
aO
aO
aO
am
bx
aO
aO
aO
bJ
am
am
am
am
aH
ac
ac
ab
ab
bs
bt
"}
(12,1,1) = {"
aa
ab
sp
sp
ab
ad
ax
ax
aq
ak
aV
am
am
am
am
am
am
am
by
am
am
am
aY
am
am
am
am
bb
bb
bb
br
ab
bs
bt
"}
(13,1,1) = {"
aa
aa
aa
aa
aa
ab
ab
ab
ab
ab
ab
ad
ak
ak
ak
ak
ad
sp
sp
sp
ad
ak
aV
ak
ad
ab
ad
bd
bh
bl
ad
ab
ab
ab
"}
(14,1,1) = {"
aa
aa
aa
aa
aa
aa
aa
aa
aa
aa
aa
ab
ab
aR
sp
aR
ab
aa
aa
aa
ab
aR
sp
aR
ab
aa
ab
ab
ab
ab
ab
aa
aa
aa
"}
