//MAP CONVERTED BY dmm2tgm.py THIS HEADER COMMENT PREVENTS RECONVERSION, DO NOT REMOVE
"aa" = (
/turf/template_noop,
/area/template_noop)
"ab" = (
/obj/effect/spawner/structure/window/shuttle,
/obj/machinery/door/firedoor/border_only{
	dir = 8
	},
/turf/open/floor/plating,
/area/external/shuttle/station/escape)
"ac" = (
/obj/structure/sign/warning/radiation,
/turf/closed/wall/mineral/titanium,
/area/external/shuttle/station/escape)
"ad" = (
/obj/effect/spawner/structure/window/shuttle,
/obj/machinery/door/firedoor/border_only{
	dir = 4
	},
/turf/open/floor/plating,
/area/external/shuttle/station/escape)
"ae" = (
/turf/closed/wall/mineral/titanium,
/area/external/shuttle/station/escape)
"af" = (
/obj/effect/spawner/structure/window/shuttle,
/obj/machinery/door/firedoor/border_only,
/turf/open/floor/plating,
/area/external/shuttle/station/escape)
"ag" = (
/obj/structure/closet/radiation{
	anchored = 1
	},
/obj/item/clothing/glasses/meson/engine,
/turf/open/floor/mineral/titanium/yellow,
/area/external/shuttle/station/escape)
"ah" = (
/obj/structure/chair/comfy/shuttle,
/turf/open/floor/mineral/titanium/yellow,
/area/external/shuttle/station/escape)
"ai" = (
/turf/open/floor/mineral/titanium/yellow,
/area/external/shuttle/station/escape)
"aj" = (
/obj/structure/chair/comfy/shuttle{
	dir = 1
	},
/turf/open/floor/mineral/titanium/yellow,
/area/external/shuttle/station/escape)
"al" = (
/obj/machinery/shower{
	dir = 8
	},
/obj/machinery/door/firedoor/border_only{
	dir = 1
	},
/turf/open/floor/noslip,
/area/external/shuttle/station/escape)
"am" = (
/obj/structure/reflector/single/mapping{
	dir = 6
	},
/obj/effect/turf_decal/stripes/line{
	dir = 8
	},
/obj/machinery/door/firedoor/border_only{
	dir = 8
	},
/obj/machinery/door/firedoor/border_only{
	dir = 1
	},
/turf/open/floor/plating,
/area/external/shuttle/station/escape)
"an" = (
/obj/structure/reflector/box/mapping,
/obj/machinery/door/firedoor/border_only{
	dir = 1
	},
/turf/open/floor/plating,
/area/external/shuttle/station/escape)
"ao" = (
/obj/structure/reflector/single/mapping{
	dir = 10
	},
/obj/effect/turf_decal/stripes/line{
	dir = 4
	},
/obj/machinery/door/firedoor/border_only{
	dir = 1
	},
/obj/machinery/door/firedoor/border_only{
	dir = 4
	},
/turf/open/floor/plating,
/area/external/shuttle/station/escape)
"ap" = (
/obj/machinery/shower{
	dir = 4
	},
/obj/machinery/door/firedoor/border_only{
	dir = 1
	},
/turf/open/floor/noslip,
/area/external/shuttle/station/escape)
"ar" = (
/obj/structure/chair/comfy/shuttle{
	dir = 8
	},
/turf/open/floor/mineral/titanium/yellow,
/area/external/shuttle/station/escape)
"as" = (
/obj/effect/turf_decal/stripes/line{
	dir = 8
	},
/obj/machinery/door/firedoor/border_only{
	dir = 8
	},
/turf/open/floor/plating,
/area/external/shuttle/station/escape)
"at" = (
/turf/open/floor/plating,
/area/external/shuttle/station/escape)
"au" = (
/obj/effect/turf_decal/stripes/line{
	dir = 4
	},
/obj/machinery/door/firedoor/border_only{
	dir = 4
	},
/turf/open/floor/plating,
/area/external/shuttle/station/escape)
"av" = (
/obj/structure/chair/comfy/shuttle{
	dir = 4
	},
/turf/open/floor/mineral/titanium/yellow,
/area/external/shuttle/station/escape)
"aw" = (
/turf/closed/wall/mineral/titanium/nodiagonal,
/area/external/shuttle/station/escape)
"aA" = (
/obj/machinery/door/airlock/titanium{
	name = "Emergency Shuttle Airlock"
	},
/obj/machinery/door/firedoor/border_only{
	dir = 4
	},
/obj/machinery/door/firedoor/border_only{
	dir = 8
	},
/turf/open/floor/plating,
/area/external/shuttle/station/escape)
"aB" = (
/obj/machinery/power/supermatter_crystal/shard/hugbox/fakecrystal,
/turf/open/floor/plating,
/area/external/shuttle/station/escape)
"aD" = (
/obj/structure/table/reinforced,
/obj/item/storage/firstaid/toxin,
/obj/item/crowbar/red,
/obj/item/storage/box/snappops{
	pixel_x = 4;
	pixel_y = -4
	},
/turf/open/floor/mineral/titanium/yellow,
/area/external/shuttle/station/escape)
"aE" = (
/obj/structure/reagent_dispensers/fueltank,
/turf/open/floor/mineral/titanium/yellow,
/area/external/shuttle/station/escape)
"aF" = (
/obj/machinery/door/airlock/titanium{
	name = "Emergency Shuttle Airlock"
	},
/obj/docking_port/mobile/emergency{
	name = "Hyperfractal Gigashuttle"
	},
/obj/machinery/door/firedoor/border_only{
	dir = 4
	},
/obj/machinery/door/firedoor/border_only{
	dir = 8
	},
/turf/open/floor/plating,
/area/external/shuttle/station/escape)
"aI" = (
/obj/structure/sign/warning/radiation,
/turf/closed/wall/mineral/titanium/nodiagonal,
/area/external/shuttle/station/escape)
"aK" = (
/obj/structure/closet/radiation{
	anchored = 1
	},
/obj/item/clothing/glasses/meson/engine,
/obj/machinery/door/firedoor/border_only{
	dir = 8
	},
/turf/open/floor/mineral/titanium/yellow,
/area/external/shuttle/station/escape)
"aL" = (
/obj/machinery/door/airlock/external{
	name = "Emergency Launch Catwalk"
	},
/obj/machinery/door/firedoor/border_only{
	dir = 1
	},
/obj/machinery/door/firedoor/border_only,
/obj/effect/mapping_helpers/airlock/access/any/engineering/general,
/obj/effect/mapping_helpers/airlock/access/any/engineering/external,
/turf/open/floor/plating,
/area/external/shuttle/station/escape)
"aM" = (
/turf/open/floor/plating/airless,
/area/external/shuttle/station/escape)
"aN" = (
/obj/structure/reflector/single/mapping{
	dir = 6
	},
/turf/open/floor/plating/airless,
/area/external/shuttle/station/escape)
"aO" = (
/obj/structure/reflector/double/mapping{
	dir = 6
	},
/turf/open/floor/plating/airless,
/area/external/shuttle/station/escape)
"aP" = (
/obj/structure/reflector/double/mapping{
	dir = 10
	},
/turf/open/floor/plating/airless,
/area/external/shuttle/station/escape)
"aQ" = (
/obj/structure/reflector/single/mapping{
	dir = 10
	},
/turf/open/floor/plating/airless,
/area/external/shuttle/station/escape)
"aR" = (
/obj/effect/turf_decal/stripes/line{
	dir = 9
	},
/turf/open/floor/plating/airless,
/area/external/shuttle/station/escape)
"aS" = (
/obj/effect/turf_decal/stripes/line{
	dir = 1
	},
/turf/open/floor/plating/airless,
/area/external/shuttle/station/escape)
"aT" = (
/obj/effect/turf_decal/stripes/line{
	dir = 5
	},
/turf/open/floor/plating/airless,
/area/external/shuttle/station/escape)
"aU" = (
/obj/effect/turf_decal/stripes/line{
	dir = 8
	},
/turf/open/floor/plating/airless,
/area/external/shuttle/station/escape)
"aV" = (
/obj/machinery/power/supermatter_crystal/shard/hugbox,
/turf/open/floor/plating/airless,
/area/external/shuttle/station/escape)
"aW" = (
/obj/effect/turf_decal/stripes/line{
	dir = 4
	},
/turf/open/floor/plating/airless,
/area/external/shuttle/station/escape)
"aX" = (
/obj/effect/turf_decal/stripes/line{
	dir = 10
	},
/turf/open/floor/plating/airless,
/area/external/shuttle/station/escape)
"aY" = (
/obj/effect/turf_decal/stripes/line{
	dir = 2
	},
/turf/open/floor/plating/airless,
/area/external/shuttle/station/escape)
"aZ" = (
/obj/effect/turf_decal/stripes/line{
	dir = 6
	},
/turf/open/floor/plating/airless,
/area/external/shuttle/station/escape)
"ba" = (
/obj/machinery/power/emitter/energycannon{
	dir = 1
	},
/turf/open/floor/plating/airless,
/area/external/shuttle/station/escape)
"bb" = (
/obj/structure/chair/comfy/shuttle,
/obj/effect/turf_decal/stripes/line{
	dir = 1
	},
/turf/open/floor/plating/airless,
/area/external/shuttle/station/escape)
"bc" = (
/obj/structure/shuttle/engine/heater,
/turf/open/floor/plating/airless,
/area/external/shuttle/station/escape)
"bd" = (
/obj/machinery/computer/emergency_shuttle{
	dir = 1
	},
/turf/open/floor/plating/airless,
/area/external/shuttle/station/escape)
"be" = (
/obj/structure/shuttle/engine/propulsion,
/turf/open/floor/plating/airless,
/area/external/shuttle/station/escape)
"bf" = (
/obj/structure/grille,
/turf/open/floor/plating,
/area/external/shuttle/station/escape)
"bg" = (
/obj/structure/grille,
/obj/effect/turf_decal/stripes/line{
	dir = 8
	},
/obj/machinery/door/firedoor/border_only{
	dir = 8
	},
/turf/open/floor/plating,
/area/external/shuttle/station/escape)
"bh" = (
/obj/structure/grille,
/obj/effect/turf_decal/stripes/line{
	dir = 4
	},
/obj/machinery/door/firedoor/border_only{
	dir = 4
	},
/turf/open/floor/plating,
/area/external/shuttle/station/escape)
"bi" = (
/obj/structure/closet/radiation{
	anchored = 1
	},
/obj/item/clothing/glasses/meson/engine,
/obj/machinery/light{
	dir = 8
	},
/obj/machinery/door/firedoor/border_only{
	dir = 1
	},
/turf/open/floor/mineral/titanium/yellow,
/area/external/shuttle/station/escape)
"bj" = (
/obj/structure/closet/radiation{
	anchored = 1
	},
/obj/item/clothing/glasses/meson/engine,
/obj/machinery/light{
	dir = 4
	},
/obj/machinery/door/firedoor/border_only{
	dir = 1
	},
/turf/open/floor/mineral/titanium/yellow,
/area/external/shuttle/station/escape)
"bk" = (
/obj/effect/turf_decal/stripes/line{
	dir = 8
	},
/obj/machinery/light{
	dir = 8
	},
/obj/machinery/door/firedoor/border_only{
	dir = 8
	},
/turf/open/floor/plating,
/area/external/shuttle/station/escape)
"bl" = (
/obj/effect/turf_decal/stripes/line{
	dir = 4
	},
/obj/machinery/light{
	dir = 4
	},
/obj/machinery/door/firedoor/border_only{
	dir = 4
	},
/turf/open/floor/plating,
/area/external/shuttle/station/escape)
"cw" = (
/obj/structure/closet/radiation{
	anchored = 1
	},
/obj/item/clothing/glasses/meson/engine,
/obj/machinery/door/firedoor/border_only,
/turf/open/floor/mineral/titanium/yellow,
/area/external/shuttle/station/escape)
"hD" = (
/obj/structure/lattice/catwalk,
/turf/open/space,
/area/external/shuttle/station/escape)
"iP" = (
/obj/structure/chair/comfy/shuttle{
	dir = 1
	},
/obj/machinery/door/firedoor/border_only{
	dir = 4
	},
/turf/open/floor/mineral/titanium/yellow,
/area/external/shuttle/station/escape)
"lY" = (
/obj/structure/chair/comfy/shuttle{
	dir = 4
	},
/obj/machinery/door/firedoor/border_only,
/turf/open/floor/mineral/titanium/yellow,
/area/external/shuttle/station/escape)
"pb" = (
/obj/structure/closet/radiation{
	anchored = 1
	},
/obj/item/clothing/glasses/meson/engine,
/obj/machinery/status_display/evac{
	pixel_x = 32
	},
/turf/open/floor/mineral/titanium/yellow,
/area/external/shuttle/station/escape)
"pW" = (
/obj/structure/chair/comfy/shuttle{
	dir = 8
	},
/obj/machinery/door/firedoor/border_only,
/turf/open/floor/mineral/titanium/yellow,
/area/external/shuttle/station/escape)
"Ap" = (
/obj/structure/closet/radiation{
	anchored = 1
	},
/obj/item/clothing/glasses/meson/engine,
/obj/machinery/door/firedoor/border_only{
	dir = 4
	},
/turf/open/floor/mineral/titanium/yellow,
/area/external/shuttle/station/escape)
"Bi" = (
/obj/structure/closet/radiation{
	anchored = 1
	},
/obj/item/clothing/glasses/meson/engine,
/obj/machinery/status_display/evac{
	pixel_x = -32
	},
/turf/open/floor/mineral/titanium/yellow,
/area/external/shuttle/station/escape)
"Eq" = (
/obj/machinery/portable_atmospherics/canister/air,
/turf/open/floor/mineral/titanium/yellow,
/area/external/shuttle/station/escape)
"Gp" = (
/obj/effect/spawner/structure/window/shuttle,
/obj/machinery/door/firedoor/border_only{
	dir = 1
	},
/turf/open/floor/plating,
/area/external/shuttle/station/escape)
"Sh" = (
/obj/structure/chair/comfy/shuttle{
	dir = 1
	},
/obj/machinery/door/firedoor/border_only{
	dir = 8
	},
/turf/open/floor/mineral/titanium/yellow,
/area/external/shuttle/station/escape)
"UA" = (
/obj/machinery/status_display/evac{
	pixel_y = -32
	},
/turf/open/floor/mineral/titanium/yellow,
/area/external/shuttle/station/escape)

(1,1,1) = {"
aa
aa
aa
aa
aa
aa
aw
aA
ac
aF
aw
aa
aa
aa
aa
aa
aa
aa
aa
aa
aa
aa
"}
(2,1,1) = {"
aw
ae
ab
ac
ae
ab
aw
ai
aD
UA
ae
aa
aa
aN
aM
aR
aU
aX
aM
ba
bc
be
"}
(3,1,1) = {"
ac
ag
ag
bi
Bi
ag
cw
ai
ai
ai
af
aa
aa
aM
aa
aS
aV
aY
aM
ba
bc
be
"}
(4,1,1) = {"
Gp
ah
ai
al
ar
ar
pW
ar
ar
Eq
aI
aw
aa
aM
aa
aT
aW
aZ
aa
hD
aa
aa
"}
(5,1,1) = {"
Gp
aK
Sh
am
as
as
as
bg
as
as
bk
af
aM
aO
aa
aa
hD
aa
aa
aR
aU
aX
"}
(6,1,1) = {"
Gp
ag
aj
an
at
at
bf
aB
bf
at
at
aL
aM
aM
hD
hD
hD
hD
hD
bb
bd
aY
"}
(7,1,1) = {"
Gp
Ap
iP
ao
au
au
au
bh
au
au
bl
af
aM
aP
aa
aa
hD
aa
aa
aT
aW
aZ
"}
(8,1,1) = {"
Gp
ah
ai
ap
av
av
lY
av
av
Eq
aI
aw
aa
aM
aa
aR
aU
aX
aa
hD
aa
aa
"}
(9,1,1) = {"
ac
ag
ag
bj
pb
ag
cw
ai
ai
ai
af
aa
aa
aM
aa
aS
aV
aY
aM
ba
bc
be
"}
(10,1,1) = {"
aw
ae
ad
ac
ae
ad
aw
ai
aE
UA
ae
aa
aa
aQ
aM
aT
aW
aZ
aM
ba
bc
be
"}
(11,1,1) = {"
aa
aa
aa
aa
aa
aa
aw
aA
ac
aA
aw
aa
aa
aa
aa
aa
aa
aa
aa
aa
aa
aa
"}
