//MAP CONVERTED BY dmm2tgm.py THIS HEADER COMMENT PREVENTS RECONVERSION, DO NOT REMOVE
"aa" = (
/turf/template_noop,
/area/template_noop)
"ab" = (
/turf/closed/wall/mineral/titanium,
/area/external/shuttle/station/escape)
"ac" = (
/obj/effect/spawner/structure/window/shuttle,
/obj/machinery/door/firedoor/border_only{
	dir = 1
	},
/turf/open/floor/plating,
/area/external/shuttle/station/escape)
"ad" = (
/obj/structure/table,
/obj/machinery/recharger,
/turf/open/floor/mineral/titanium,
/area/external/shuttle/station/escape)
"ae" = (
/obj/machinery/computer/emergency_shuttle,
/turf/open/floor/mineral/titanium/blue,
/area/external/shuttle/station/escape)
"af" = (
/obj/machinery/computer/communications/unlocked,
/turf/open/floor/mineral/titanium/blue,
/area/external/shuttle/station/escape)
"ag" = (
/obj/machinery/computer/atmos_alert{
	dir = 4
	},
/turf/open/floor/mineral/titanium/blue,
/area/external/shuttle/station/escape)
"ah" = (
/obj/structure/chair/comfy/black{
	dir = 1
	},
/turf/open/floor/mineral/titanium/blue,
/area/external/shuttle/station/escape)
"ai" = (
/obj/machinery/computer/security{
	dir = 8
	},
/turf/open/floor/mineral/titanium/blue,
/area/external/shuttle/station/escape)
"aj" = (
/obj/machinery/computer/crew{
	dir = 4
	},
/turf/open/floor/mineral/titanium/blue,
/area/external/shuttle/station/escape)
"ak" = (
/obj/machinery/computer/secure_data{
	dir = 8
	},
/turf/open/floor/mineral/titanium/blue,
/area/external/shuttle/station/escape)
"al" = (
/obj/structure/chair/office/dark{
	dir = 8
	},
/turf/open/floor/mineral/titanium/blue,
/area/external/shuttle/station/escape)
"am" = (
/obj/item/kirbyplants{
	icon_state = "plant-22"
	},
/obj/machinery/door/firedoor/border_only{
	dir = 4
	},
/turf/open/floor/mineral/plastitanium/red/brig,
/area/external/shuttle/station/escape)
"an" = (
/obj/machinery/light{
	dir = 1
	},
/turf/open/floor/mineral/plastitanium/red/brig,
/area/external/shuttle/station/escape)
"ao" = (
/obj/item/kirbyplants{
	icon_state = "plant-22"
	},
/obj/machinery/door/firedoor/border_only{
	dir = 8
	},
/turf/open/floor/mineral/plastitanium/red/brig,
/area/external/shuttle/station/escape)
"ap" = (
/obj/structure/chair/comfy,
/obj/machinery/computer/security/telescreen/entertainment{
	pixel_y = 32
	},
/obj/effect/turf_decal/tile/green{
	dir = 1
	},
/obj/effect/turf_decal/tile/green{
	dir = 4
	},
/obj/effect/turf_decal/tile/green{
	dir = 8
	},
/turf/open/floor/plasteel/dark,
/area/external/shuttle/station/escape)
"aq" = (
/obj/structure/chair/office/dark{
	dir = 4
	},
/turf/open/floor/mineral/titanium/blue,
/area/external/shuttle/station/escape)
"ar" = (
/turf/open/floor/carpet/black,
/area/external/shuttle/station/escape)
"as" = (
/obj/machinery/computer/security/telescreen/entertainment{
	pixel_y = 32
	},
/obj/item/kirbyplants{
	icon_state = "plant-21";
	pixel_x = -3;
	pixel_y = 3
	},
/obj/effect/turf_decal/tile/green{
	dir = 1
	},
/obj/effect/turf_decal/tile/green,
/obj/effect/turf_decal/tile/green{
	dir = 4
	},
/turf/open/floor/plasteel/dark,
/area/external/shuttle/station/escape)
"at" = (
/obj/effect/turf_decal/tile/green{
	dir = 1
	},
/obj/effect/turf_decal/tile/green{
	dir = 8
	},
/turf/open/floor/plasteel/dark,
/area/external/shuttle/station/escape)
"au" = (
/turf/open/floor/plasteel/dark,
/area/external/shuttle/station/escape)
"av" = (
/obj/structure/table/wood/poker,
/obj/item/toy/cards/deck{
	pixel_y = 5
	},
/obj/machinery/door/firedoor/border_only{
	dir = 8
	},
/turf/open/floor/plasteel/dark,
/area/external/shuttle/station/escape)
"aw" = (
/obj/structure/chair/comfy{
	dir = 8
	},
/obj/effect/turf_decal/tile/green,
/obj/effect/turf_decal/tile/green{
	dir = 4
	},
/turf/open/floor/plasteel/dark,
/area/external/shuttle/station/escape)
"ax" = (
/turf/open/floor/mineral/plastitanium/red/brig,
/area/external/shuttle/station/escape)
"ay" = (
/obj/machinery/door/airlock/titanium{
	name = "Emergency Shuttle Airlock"
	},
/obj/machinery/door/firedoor/border_only{
	dir = 4
	},
/obj/machinery/door/firedoor/border_only{
	dir = 8
	},
/turf/open/floor/plating,
/area/external/shuttle/station/escape)
"az" = (
/obj/structure/chair/comfy{
	dir = 1
	},
/obj/structure/window/reinforced,
/obj/effect/turf_decal/tile/green{
	dir = 1
	},
/obj/effect/turf_decal/tile/green,
/obj/effect/turf_decal/tile/green{
	dir = 8
	},
/turf/open/floor/plasteel/dark,
/area/external/shuttle/station/escape)
"aA" = (
/obj/structure/chair/comfy{
	dir = 1
	},
/obj/structure/window/reinforced,
/obj/effect/turf_decal/tile/green,
/obj/effect/turf_decal/tile/green{
	dir = 8
	},
/obj/machinery/door/firedoor/border_only{
	dir = 4
	},
/turf/open/floor/plasteel/dark,
/area/external/shuttle/station/escape)
"aB" = (
/obj/structure/window/reinforced,
/obj/item/kirbyplants{
	icon_state = "plant-11"
	},
/obj/effect/turf_decal/tile/green,
/obj/effect/turf_decal/tile/green{
	dir = 4
	},
/obj/effect/turf_decal/tile/green{
	dir = 8
	},
/turf/open/floor/plasteel/dark,
/area/external/shuttle/station/escape)
"aC" = (
/obj/structure/window/reinforced,
/obj/effect/turf_decal/tile/green,
/obj/effect/turf_decal/tile/green{
	dir = 4
	},
/obj/effect/turf_decal/tile/green{
	dir = 8
	},
/obj/machinery/portable_atmospherics/canister/air,
/turf/open/floor/plasteel/dark,
/area/external/shuttle/station/escape)
"aD" = (
/obj/structure/chair/comfy{
	dir = 1
	},
/obj/effect/turf_decal/tile/green{
	dir = 1
	},
/obj/effect/turf_decal/tile/green,
/obj/effect/turf_decal/tile/green{
	dir = 8
	},
/turf/open/floor/plasteel/dark,
/area/external/shuttle/station/escape)
"aE" = (
/obj/structure/chair/comfy,
/obj/machinery/computer/security/telescreen/entertainment{
	pixel_y = 32
	},
/obj/machinery/light{
	dir = 1
	},
/obj/effect/turf_decal/tile/green{
	dir = 1
	},
/obj/effect/turf_decal/tile/green{
	dir = 4
	},
/obj/machinery/door/firedoor/border_only{
	dir = 4
	},
/turf/open/floor/plasteel/dark,
/area/external/shuttle/station/escape)
"aF" = (
/obj/structure/chair/comfy{
	dir = 1
	},
/obj/effect/turf_decal/tile/green,
/obj/effect/turf_decal/tile/green{
	dir = 4
	},
/obj/effect/turf_decal/tile/green{
	dir = 8
	},
/turf/open/floor/plasteel/dark,
/area/external/shuttle/station/escape)
"aG" = (
/obj/structure/closet/secure_closet/freezer/fridge,
/obj/structure/window/reinforced{
	dir = 8;
	layer = 2.9
	},
/obj/machinery/light{
	dir = 1
	},
/obj/item/reagent_containers/food/snacks/butterdog,
/obj/item/reagent_containers/food/snacks/cakeslice/apple,
/obj/item/reagent_containers/food/snacks/cakeslice/brioche,
/obj/item/reagent_containers/food/snacks/cakeslice/cheese,
/obj/item/reagent_containers/food/snacks/cakeslice/chocolate,
/obj/item/reagent_containers/food/snacks/cakeslice/lemon,
/obj/item/reagent_containers/food/snacks/cakeslice/lime,
/obj/item/reagent_containers/food/snacks/cakeslice/orange,
/turf/open/floor/plasteel/cafeteria,
/area/external/shuttle/station/escape)
"aH" = (
/turf/open/floor/mineral/titanium,
/area/external/shuttle/station/escape)
"aI" = (
/obj/machinery/door/airlock/public/glass{
	name = "First Class"
	},
/obj/machinery/door/firedoor/border_only{
	dir = 1
	},
/obj/machinery/door/firedoor/border_only,
/turf/open/floor/plating,
/area/external/shuttle/station/escape)
"aJ" = (
/obj/structure/chair/comfy/shuttle,
/obj/effect/turf_decal/tile/purple{
	dir = 1
	},
/obj/effect/turf_decal/tile/purple{
	dir = 4
	},
/obj/effect/turf_decal/tile/purple{
	dir = 8
	},
/turf/open/floor/plasteel/dark,
/area/external/shuttle/station/escape)
"aK" = (
/obj/structure/chair/comfy{
	dir = 1
	},
/obj/machinery/light,
/obj/effect/turf_decal/tile/green,
/obj/effect/turf_decal/tile/green{
	dir = 8
	},
/obj/machinery/door/firedoor/border_only{
	dir = 4
	},
/turf/open/floor/plasteel/dark,
/area/external/shuttle/station/escape)
"aL" = (
/obj/structure/chair/comfy/shuttle,
/obj/effect/turf_decal/tile/purple{
	dir = 1
	},
/obj/effect/turf_decal/tile/purple,
/obj/effect/turf_decal/tile/purple{
	dir = 4
	},
/turf/open/floor/plasteel/dark,
/area/external/shuttle/station/escape)
"aM" = (
/obj/effect/turf_decal/tile/purple{
	dir = 1
	},
/obj/effect/turf_decal/tile/purple{
	dir = 8
	},
/turf/open/floor/plasteel/dark,
/area/external/shuttle/station/escape)
"aN" = (
/obj/structure/table/glass,
/obj/item/reagent_containers/food/drinks/bottle/wine,
/obj/effect/turf_decal/tile/green{
	dir = 1
	},
/obj/effect/turf_decal/tile/green{
	dir = 8
	},
/turf/open/floor/plasteel/dark,
/area/external/shuttle/station/escape)
"aO" = (
/obj/structure/chair/comfy/shuttle{
	dir = 1
	},
/obj/structure/window/reinforced,
/obj/effect/turf_decal/tile/purple{
	dir = 1
	},
/obj/effect/turf_decal/tile/purple,
/obj/effect/turf_decal/tile/purple{
	dir = 8
	},
/turf/open/floor/plasteel/dark,
/area/external/shuttle/station/escape)
"aP" = (
/obj/structure/chair/comfy/shuttle{
	dir = 1
	},
/obj/structure/window/reinforced,
/obj/effect/turf_decal/tile/purple,
/obj/effect/turf_decal/tile/purple{
	dir = 8
	},
/obj/machinery/door/firedoor/border_only{
	dir = 4
	},
/turf/open/floor/plasteel/dark,
/area/external/shuttle/station/escape)
"aQ" = (
/obj/structure/chair/comfy/shuttle{
	dir = 1
	},
/obj/structure/window/reinforced,
/obj/effect/turf_decal/tile/purple,
/obj/effect/turf_decal/tile/purple{
	dir = 4
	},
/obj/effect/turf_decal/tile/purple{
	dir = 8
	},
/turf/open/floor/plasteel/dark,
/area/external/shuttle/station/escape)
"aR" = (
/obj/effect/turf_decal/tile/purple,
/obj/effect/turf_decal/tile/purple{
	dir = 4
	},
/turf/open/floor/plasteel/dark,
/area/external/shuttle/station/escape)
"aS" = (
/obj/structure/chair/comfy/shuttle{
	dir = 1
	},
/obj/effect/turf_decal/tile/purple{
	dir = 1
	},
/obj/effect/turf_decal/tile/purple,
/obj/effect/turf_decal/tile/purple{
	dir = 8
	},
/turf/open/floor/plasteel/dark,
/area/external/shuttle/station/escape)
"aT" = (
/obj/structure/chair/comfy/shuttle,
/obj/machinery/light{
	dir = 1
	},
/obj/effect/turf_decal/tile/purple{
	dir = 1
	},
/obj/effect/turf_decal/tile/purple{
	dir = 4
	},
/obj/machinery/door/firedoor/border_only{
	dir = 4
	},
/turf/open/floor/plasteel/dark,
/area/external/shuttle/station/escape)
"aU" = (
/obj/structure/chair/comfy/shuttle{
	dir = 1
	},
/obj/effect/turf_decal/tile/purple,
/obj/effect/turf_decal/tile/purple{
	dir = 4
	},
/obj/effect/turf_decal/tile/purple{
	dir = 8
	},
/turf/open/floor/plasteel/dark,
/area/external/shuttle/station/escape)
"aV" = (
/obj/item/reagent_containers/food/snacks/breadslice/plain,
/obj/item/reagent_containers/food/snacks/breadslice/plain{
	pixel_y = 4
	},
/obj/item/reagent_containers/food/snacks/breadslice/plain{
	pixel_y = 8
	},
/obj/structure/table/glass,
/obj/machinery/door/firedoor/border_only{
	dir = 4
	},
/turf/open/floor/plasteel/dark,
/area/external/shuttle/station/escape)
"aW" = (
/obj/structure/table,
/obj/machinery/microwave,
/turf/open/floor/plasteel/cafeteria,
/area/external/shuttle/station/escape)
"aX" = (
/obj/effect/turf_decal/tile/blue{
	dir = 4
	},
/obj/effect/turf_decal/tile/blue{
	dir = 8
	},
/obj/machinery/stasis,
/turf/open/floor/plasteel/white,
/area/external/shuttle/station/escape)
"aY" = (
/obj/structure/chair/comfy/shuttle{
	dir = 1
	},
/obj/machinery/light,
/obj/effect/turf_decal/tile/purple,
/obj/effect/turf_decal/tile/purple{
	dir = 8
	},
/obj/machinery/door/firedoor/border_only{
	dir = 4
	},
/turf/open/floor/plasteel/dark,
/area/external/shuttle/station/escape)
"aZ" = (
/obj/structure/table/glass,
/obj/machinery/light{
	dir = 1
	},
/obj/item/storage/firstaid/regular,
/obj/structure/window/reinforced{
	dir = 4;
	layer = 2.9
	},
/obj/effect/turf_decal/tile/blue{
	dir = 4
	},
/obj/effect/turf_decal/tile/blue{
	dir = 8
	},
/obj/machinery/vending/wallmed{
	pixel_y = 30
	},
/turf/open/floor/plasteel/white,
/area/external/shuttle/station/escape)
"ba" = (
/turf/open/floor/plasteel/cafeteria,
/area/external/shuttle/station/escape)
"bb" = (
/obj/effect/turf_decal/tile/blue{
	dir = 4
	},
/obj/effect/turf_decal/tile/blue{
	dir = 8
	},
/turf/open/floor/plasteel/white,
/area/external/shuttle/station/escape)
"bc" = (
/obj/structure/shuttle/engine/propulsion,
/turf/open/floor/plating/airless,
/area/external/shuttle/station/escape)
"bd" = (
/obj/structure/window/reinforced,
/obj/structure/window/reinforced{
	dir = 8;
	layer = 2.9
	},
/obj/structure/table,
/obj/item/reagent_containers/food/snacks/beans{
	pixel_x = 3;
	pixel_y = 4
	},
/turf/open/floor/plasteel/cafeteria,
/area/external/shuttle/station/escape)
"be" = (
/obj/structure/chair/comfy/shuttle,
/obj/effect/turf_decal/tile/blue{
	dir = 4
	},
/obj/effect/turf_decal/tile/blue{
	dir = 8
	},
/turf/open/floor/plasteel/white,
/area/external/shuttle/station/escape)
"bf" = (
/obj/structure/window/reinforced,
/obj/structure/table,
/obj/item/storage/bag/tray,
/turf/open/floor/plasteel/cafeteria,
/area/external/shuttle/station/escape)
"bg" = (
/obj/structure/closet/crate,
/obj/item/storage/toolbox/mechanical,
/turf/open/floor/plating,
/area/external/shuttle/station/escape)
"bh" = (
/obj/structure/window/reinforced,
/obj/structure/table/glass,
/obj/item/defibrillator/loaded,
/obj/effect/turf_decal/tile/blue{
	dir = 4
	},
/obj/effect/turf_decal/tile/blue{
	dir = 8
	},
/turf/open/floor/plasteel/white,
/area/external/shuttle/station/escape)
"bi" = (
/obj/structure/window/reinforced,
/obj/structure/window/reinforced{
	dir = 4
	},
/obj/structure/table/glass,
/obj/item/storage/firstaid/regular,
/obj/effect/turf_decal/tile/blue{
	dir = 4
	},
/obj/effect/turf_decal/tile/blue{
	dir = 8
	},
/turf/open/floor/plasteel/white,
/area/external/shuttle/station/escape)
"bj" = (
/obj/machinery/door/firedoor/border_only{
	dir = 8
	},
/turf/open/floor/plating,
/area/external/shuttle/station/escape)
"bk" = (
/obj/machinery/vending/snack,
/turf/open/floor/plating,
/area/external/shuttle/station/escape)
"bl" = (
/obj/structure/reagent_dispensers/fueltank,
/turf/open/floor/plating,
/area/external/shuttle/station/escape)
"bm" = (
/obj/machinery/vending/cola,
/turf/open/floor/plating,
/area/external/shuttle/station/escape)
"bn" = (
/obj/structure/closet/crate{
	icon_state = "crateopen"
	},
/obj/machinery/light,
/obj/item/storage/toolbox/mechanical,
/obj/machinery/door/firedoor/border_only{
	dir = 4
	},
/turf/open/floor/plating,
/area/external/shuttle/station/escape)
"bo" = (
/obj/structure/chair/comfy/shuttle,
/obj/structure/window/reinforced{
	dir = 1;
	pixel_y = 2
	},
/turf/open/floor/plating,
/area/external/shuttle/station/escape)
"bp" = (
/obj/effect/spawner/structure/window/plastitanium,
/obj/machinery/door/firedoor/border_only{
	dir = 8
	},
/turf/open/floor/plating,
/area/external/shuttle/station/escape)
"bq" = (
/obj/structure/chair/comfy/shuttle{
	dir = 1
	},
/turf/open/floor/plating,
/area/external/shuttle/station/escape)
"br" = (
/obj/machinery/light,
/obj/structure/chair/office/dark{
	dir = 8
	},
/turf/open/floor/mineral/titanium/blue,
/area/external/shuttle/station/escape)
"bs" = (
/turf/closed/wall/mineral/plastitanium,
/area/external/shuttle/station/escape)
"bt" = (
/obj/machinery/light,
/obj/structure/chair/office/dark{
	dir = 4
	},
/turf/open/floor/mineral/titanium/blue,
/area/external/shuttle/station/escape)
"bu" = (
/obj/structure/chair/comfy/shuttle{
	dir = 4
	},
/obj/machinery/door/firedoor/border_only{
	dir = 4
	},
/turf/open/floor/mineral/plastitanium/red/brig,
/area/external/shuttle/station/escape)
"bv" = (
/obj/structure/chair/comfy/shuttle{
	dir = 8
	},
/obj/machinery/door/firedoor/border_only{
	dir = 8
	},
/turf/open/floor/mineral/plastitanium/red/brig,
/area/external/shuttle/station/escape)
"bw" = (
/obj/effect/spawner/structure/window/plastitanium,
/obj/machinery/door/firedoor/border_only{
	dir = 4
	},
/turf/open/floor/plating,
/area/external/shuttle/station/escape)
"by" = (
/obj/structure/table/reinforced,
/obj/machinery/recharger,
/turf/open/floor/mineral/plastitanium/red/brig,
/area/external/shuttle/station/escape)
"bz" = (
/obj/structure/table/reinforced,
/obj/item/restraints/handcuffs,
/obj/item/melee/baton,
/turf/open/floor/mineral/plastitanium/red/brig,
/area/external/shuttle/station/escape)
"bA" = (
/obj/machinery/door/airlock/public/glass,
/obj/machinery/door/firedoor/border_only{
	dir = 1
	},
/obj/machinery/door/firedoor/border_only,
/obj/effect/mapping_helpers/airlock/access/all/security/general,
/turf/open/floor/mineral/plastitanium/red/brig,
/area/external/shuttle/station/escape)
"bB" = (
/obj/structure/window/reinforced{
	dir = 4;
	layer = 2.9
	},
/turf/open/floor/mineral/plastitanium/red/brig,
/area/external/shuttle/station/escape)
"bC" = (
/obj/structure/window/reinforced{
	dir = 8;
	layer = 2.9
	},
/turf/open/floor/mineral/plastitanium/red/brig,
/area/external/shuttle/station/escape)
"bD" = (
/obj/structure/bed,
/turf/open/floor/mineral/plastitanium/red/brig,
/area/external/shuttle/station/escape)
"bE" = (
/obj/structure/shuttle/engine/heater,
/obj/structure/window/plastitanium,
/turf/open/floor/plating,
/area/external/shuttle/station/escape)
"bG" = (
/obj/structure/chair/comfy/shuttle{
	dir = 1
	},
/obj/machinery/light,
/obj/machinery/door/firedoor/border_only{
	dir = 8
	},
/turf/open/floor/plating,
/area/external/shuttle/station/escape)
"bI" = (
/obj/machinery/light,
/turf/open/floor/mineral/plastitanium/red/brig,
/area/external/shuttle/station/escape)
"bK" = (
/obj/machinery/door/airlock/public/glass{
	name = "Economy Class"
	},
/obj/machinery/door/firedoor/border_only{
	dir = 1
	},
/obj/machinery/door/firedoor/border_only,
/turf/open/floor/plating,
/area/external/shuttle/station/escape)
"bL" = (
/obj/machinery/door/airlock/titanium{
	name = "Emergency Shuttle Airlock"
	},
/obj/docking_port/mobile/emergency{
	dir = 8;
	dwidth = 27;
	height = 8;
	name = "PubbyStation emergency shuttle";
	port_direction = 4;
	preferred_direction = 1;
	width = 46
	},
/obj/machinery/door/firedoor/border_only{
	dir = 4
	},
/obj/machinery/door/firedoor/border_only{
	dir = 8
	},
/turf/open/floor/plating,
/area/external/shuttle/station/escape)
"bO" = (
/obj/machinery/door/airlock/public/glass{
	name = "Cockpit"
	},
/obj/machinery/door/firedoor/border_only{
	dir = 1
	},
/obj/machinery/door/firedoor/border_only,
/obj/effect/mapping_helpers/airlock/access/all/command/general,
/turf/open/floor/plating,
/area/external/shuttle/station/escape)
"bQ" = (
/obj/machinery/door/airlock/public/glass{
	name = "Service"
	},
/obj/machinery/door/firedoor/border_only{
	dir = 1
	},
/obj/machinery/door/firedoor/border_only,
/turf/open/floor/plating,
/area/external/shuttle/station/escape)
"bT" = (
/obj/machinery/door/airlock/public/glass{
	name = "Brig"
	},
/obj/machinery/door/firedoor/border_only{
	dir = 1
	},
/obj/machinery/door/firedoor/border_only,
/obj/effect/mapping_helpers/airlock/access/all/security/basic,
/turf/open/floor/plating,
/area/external/shuttle/station/escape)
"cM" = (
/obj/structure/chair/comfy,
/obj/machinery/computer/security/telescreen/entertainment{
	pixel_y = 32
	},
/obj/machinery/light{
	dir = 1
	},
/obj/effect/turf_decal/tile/green{
	dir = 1
	},
/obj/effect/turf_decal/tile/green{
	dir = 4
	},
/obj/machinery/door/firedoor/border_only{
	dir = 8
	},
/turf/open/floor/plasteel/dark,
/area/external/shuttle/station/escape)
"lW" = (
/obj/structure/chair/comfy{
	dir = 1
	},
/obj/structure/window/reinforced,
/obj/effect/turf_decal/tile/green,
/obj/effect/turf_decal/tile/green{
	dir = 8
	},
/obj/machinery/door/firedoor/border_only{
	dir = 8
	},
/turf/open/floor/plasteel/dark,
/area/external/shuttle/station/escape)
"od" = (
/obj/structure/chair/comfy/shuttle{
	dir = 1
	},
/obj/structure/window/reinforced,
/obj/effect/turf_decal/tile/purple,
/obj/effect/turf_decal/tile/purple{
	dir = 8
	},
/obj/machinery/door/firedoor/border_only{
	dir = 8
	},
/turf/open/floor/plasteel/dark,
/area/external/shuttle/station/escape)
"oJ" = (
/obj/structure/chair/comfy/shuttle,
/obj/machinery/light{
	dir = 1
	},
/obj/effect/turf_decal/tile/purple{
	dir = 1
	},
/obj/effect/turf_decal/tile/purple{
	dir = 4
	},
/obj/machinery/door/firedoor/border_only{
	dir = 8
	},
/turf/open/floor/plasteel/dark,
/area/external/shuttle/station/escape)
"us" = (
/obj/structure/chair/comfy{
	dir = 1
	},
/obj/machinery/light,
/obj/effect/turf_decal/tile/green,
/obj/effect/turf_decal/tile/green{
	dir = 8
	},
/obj/machinery/door/firedoor/border_only{
	dir = 8
	},
/turf/open/floor/plasteel/dark,
/area/external/shuttle/station/escape)
"uz" = (
/obj/structure/reagent_dispensers/fueltank,
/obj/machinery/door/firedoor/border_only{
	dir = 4
	},
/turf/open/floor/plating,
/area/external/shuttle/station/escape)
"vy" = (
/obj/machinery/portable_atmospherics/canister/air,
/obj/machinery/door/firedoor/border_only{
	dir = 4
	},
/turf/open/floor/plating,
/area/external/shuttle/station/escape)
"wy" = (
/obj/effect/spawner/structure/window/shuttle,
/obj/machinery/door/firedoor/border_only{
	dir = 4
	},
/turf/open/floor/plating,
/area/external/shuttle/station/escape)
"xt" = (
/obj/structure/window/reinforced{
	dir = 8;
	layer = 2.9
	},
/turf/open/floor/plating,
/area/external/shuttle/station/escape)
"yR" = (
/obj/effect/turf_decal/tile/blue{
	dir = 4
	},
/obj/effect/turf_decal/tile/blue{
	dir = 8
	},
/obj/machinery/door/firedoor/border_only{
	dir = 4
	},
/turf/open/floor/plasteel/white,
/area/external/shuttle/station/escape)
"zv" = (
/obj/effect/spawner/structure/window/shuttle,
/obj/machinery/door/firedoor/border_only{
	dir = 8
	},
/turf/open/floor/plating,
/area/external/shuttle/station/escape)
"AG" = (
/obj/machinery/door/firedoor/border_only{
	dir = 8
	},
/turf/open/floor/plasteel/dark,
/area/external/shuttle/station/escape)
"HF" = (
/obj/structure/window/reinforced,
/obj/effect/turf_decal/tile/purple,
/obj/effect/turf_decal/tile/purple{
	dir = 4
	},
/obj/effect/turf_decal/tile/purple{
	dir = 8
	},
/obj/machinery/portable_atmospherics/canister/air,
/turf/open/floor/plasteel/dark,
/area/external/shuttle/station/escape)
"Ri" = (
/obj/structure/chair/comfy/shuttle{
	dir = 1
	},
/obj/machinery/light,
/obj/effect/turf_decal/tile/purple,
/obj/effect/turf_decal/tile/purple{
	dir = 8
	},
/obj/machinery/door/firedoor/border_only{
	dir = 8
	},
/turf/open/floor/plasteel/dark,
/area/external/shuttle/station/escape)
"Uu" = (
/obj/structure/window/reinforced{
	dir = 4
	},
/turf/open/floor/plating,
/area/external/shuttle/station/escape)
"XK" = (
/obj/machinery/door/firedoor/border_only{
	dir = 8
	},
/turf/open/floor/plasteel/cafeteria,
/area/external/shuttle/station/escape)
"XQ" = (
/obj/machinery/door/firedoor/border_only{
	dir = 4
	},
/turf/open/floor/plasteel/dark,
/area/external/shuttle/station/escape)
"XY" = (
/obj/structure/chair/comfy/shuttle,
/obj/structure/window/reinforced{
	dir = 1;
	pixel_y = 2
	},
/obj/machinery/door/firedoor/border_only{
	dir = 8
	},
/turf/open/floor/plating,
/area/external/shuttle/station/escape)

(1,1,1) = {"
aa
ab
zv
zv
ab
aa
ab
ab
zv
ab
zv
ab
zv
ab
ab
aa
ab
ab
zv
ab
zv
ab
zv
ab
ab
aa
ab
ab
zv
ab
zv
ab
zv
ab
ab
aa
bs
bs
bp
bp
bs
bs
bp
bp
bs
bs
"}
(2,1,1) = {"
ab
ab
ag
aj
ab
aa
ab
ap
aN
az
at
az
at
aD
ab
aa
ab
aJ
aM
aO
aM
aO
aM
aS
ab
aa
ab
aX
bb
be
bh
bl
bg
bg
ab
aa
bs
am
bu
bu
bu
bs
ax
bD
bE
bc
"}
(3,1,1) = {"
ac
ad
al
br
ab
aa
ab
aE
aV
aA
XQ
aA
XQ
aK
ab
aa
ab
aT
XQ
aP
XQ
aP
XQ
aY
ab
aa
ab
aZ
yR
yR
bi
uz
vy
bn
ab
aa
bs
an
ax
ax
ax
bA
ax
bI
bE
bc
"}
(4,1,1) = {"
ac
ae
ah
aH
bO
xt
aI
ar
ar
ar
ar
ar
ar
ar
aI
xt
bK
ar
ar
ar
ar
ar
ar
ar
bK
xt
bQ
au
au
au
au
au
au
au
bQ
xt
bT
ax
ax
by
ax
bs
bB
bB
bE
bc
"}
(5,1,1) = {"
ac
af
ah
aH
bO
Uu
aI
ar
ar
ar
ar
ar
ar
ar
aI
Uu
bK
ar
ar
ar
ar
ar
ar
ar
bK
Uu
bQ
au
au
au
au
au
au
au
bQ
Uu
bT
ax
ax
bz
ax
bs
bC
bC
bE
bc
"}
(6,1,1) = {"
ac
ad
aq
bt
ab
aa
ab
cM
av
lW
AG
lW
AG
us
ab
aa
ab
oJ
AG
od
AG
od
AG
Ri
ab
aa
ab
aG
XK
bd
bj
bj
XY
bG
ab
aa
bs
an
ax
ax
ax
bA
ax
bI
bE
bc
"}
(7,1,1) = {"
ab
ab
ai
ak
ab
aa
ab
as
aw
aB
au
aC
au
aF
ab
aa
ab
aL
au
aQ
au
HF
aR
aU
ab
aa
ab
aW
ba
bf
bk
bm
bo
bq
ab
aa
bs
ao
bv
bv
bv
bs
ax
bD
bE
bc
"}
(8,1,1) = {"
aa
ab
wy
wy
ab
aa
ab
ab
ab
ab
ay
ab
ay
ab
ab
aa
ab
ab
bL
ab
ay
ab
wy
ab
ab
aa
ab
ab
wy
ab
wy
ab
wy
ab
ab
aa
bs
bs
bw
bw
bs
bs
bw
bw
bs
bs
"}
