//MAP CONVERTED BY dmm2tgm.py THIS HEADER COMMENT PREVENTS RECONVERSION, DO NOT REMOVE
"aa" = (
/turf/template_noop,
/area/template_noop)
"ab" = (
/turf/closed/wall/mineral/titanium,
/area/external/shuttle/station/escape)
"ac" = (
/obj/effect/spawner/structure/window/shuttle,
/obj/machinery/door/firedoor/border_only{
	dir = 1
	},
/turf/open/floor/plating,
/area/external/shuttle/station/escape)
"ad" = (
/obj/effect/turf_decal/tile/green{
	dir = 1
	},
/obj/effect/turf_decal/tile/green,
/obj/effect/turf_decal/tile/green{
	dir = 4
	},
/obj/effect/turf_decal/tile/green{
	dir = 8
	},
/turf/open/floor/plasteel,
/area/external/shuttle/station/escape)
"ae" = (
/obj/effect/turf_decal/tile/green{
	dir = 1
	},
/obj/effect/turf_decal/tile/green,
/obj/effect/turf_decal/tile/green{
	dir = 4
	},
/obj/effect/turf_decal/tile/green{
	dir = 8
	},
/turf/open/floor/plasteel/dark,
/area/external/shuttle/station/escape)
"af" = (
/obj/machinery/power/emitter/energycannon/magical,
/obj/effect/turf_decal/tile/green{
	dir = 1
	},
/obj/effect/turf_decal/tile/green,
/obj/effect/turf_decal/tile/green{
	dir = 4
	},
/obj/effect/turf_decal/tile/green{
	dir = 8
	},
/turf/open/floor/plasteel/dark,
/area/external/shuttle/station/escape)
"ag" = (
/obj/structure/table/abductor/wabbajack/left,
/obj/effect/turf_decal/tile/green{
	dir = 1
	},
/obj/effect/turf_decal/tile/green,
/obj/effect/turf_decal/tile/green{
	dir = 4
	},
/obj/effect/turf_decal/tile/green{
	dir = 8
	},
/turf/open/floor/plasteel/dark,
/area/external/shuttle/station/escape)
"ah" = (
/obj/structure/table/abductor/wabbajack/right,
/obj/effect/turf_decal/tile/green{
	dir = 1
	},
/obj/effect/turf_decal/tile/green,
/obj/effect/turf_decal/tile/green{
	dir = 4
	},
/obj/effect/turf_decal/tile/green{
	dir = 8
	},
/turf/open/floor/plasteel/dark,
/area/external/shuttle/station/escape)
"ai" = (
/obj/structure/sign/warning/biohazard,
/turf/closed/wall/mineral/titanium,
/area/external/shuttle/station/escape)
"aj" = (
/obj/structure/barricade/wooden,
/obj/machinery/door/airlock/titanium,
/obj/machinery/door/firedoor/border_only{
	dir = 1
	},
/obj/machinery/door/firedoor/border_only,
/turf/open/floor/plasteel/cult,
/area/external/shuttle/station/escape)
"ak" = (
/obj/structure/chair/comfy/shuttle{
	dir = 4
	},
/turf/open/floor/mineral/plastitanium/red/brig,
/area/external/shuttle/station/escape)
"al" = (
/turf/open/floor/mineral/plastitanium/red/brig,
/area/external/shuttle/station/escape)
"am" = (
/obj/structure/chair/comfy/shuttle{
	dir = 8
	},
/turf/open/floor/mineral/plastitanium/red/brig,
/area/external/shuttle/station/escape)
"an" = (
/obj/structure/table/wood,
/obj/item/candle/infinite,
/turf/open/floor/plasteel/cult,
/area/external/shuttle/station/escape)
"ao" = (
/obj/structure/barricade/wooden,
/turf/open/floor/plasteel/cult,
/area/external/shuttle/station/escape)
"ap" = (
/turf/open/floor/plasteel/cult,
/area/external/shuttle/station/escape)
"aq" = (
/turf/open/floor/mineral/titanium,
/area/external/shuttle/station/escape)
"ar" = (
/obj/structure/table,
/obj/item/storage/firstaid/fire,
/obj/item/storage/firstaid/regular{
	pixel_x = 2;
	pixel_y = 3
	},
/obj/item/crowbar,
/turf/open/floor/mineral/titanium,
/area/external/shuttle/station/escape)
"as" = (
/obj/effect/spawner/structure/window/shuttle,
/turf/open/floor/plating,
/area/external/shuttle/station/escape)
"at" = (
/obj/machinery/flasher{
	id = "shuttle_flasher";
	pixel_x = -24;
	pixel_y = 6
	},
/obj/machinery/button/flasher{
	id = "shuttle_flasher";
	pixel_x = -24;
	pixel_y = -6
	},
/obj/structure/chair/comfy/shuttle{
	dir = 4
	},
/turf/open/floor/mineral/plastitanium/red/brig,
/area/external/shuttle/station/escape)
"au" = (
/obj/structure/chair/wood,
/turf/open/floor/plasteel/cult,
/area/external/shuttle/station/escape)
"av" = (
/obj/structure/chair/comfy/shuttle,
/turf/open/floor/mineral/titanium,
/area/external/shuttle/station/escape)
"aw" = (
/obj/structure/chair/comfy/shuttle{
	dir = 8
	},
/turf/open/floor/mineral/titanium,
/area/external/shuttle/station/escape)
"ax" = (
/obj/machinery/door/airlock/titanium{
	name = "Emergency Shuttle Airlock"
	},
/obj/machinery/door/firedoor/border_only{
	dir = 4
	},
/obj/machinery/door/firedoor/border_only{
	dir = 8
	},
/obj/effect/mapping_helpers/airlock/access/all/security/basic,
/turf/open/floor/plating,
/area/external/shuttle/station/escape)
"ay" = (
/obj/structure/table,
/obj/item/paper_bin,
/obj/item/pen{
	pixel_x = -2;
	pixel_y = 4
	},
/turf/open/floor/mineral/titanium,
/area/external/shuttle/station/escape)
"az" = (
/obj/machinery/computer/emergency_shuttle{
	dir = 1
	},
/turf/open/floor/mineral/titanium,
/area/external/shuttle/station/escape)
"aA" = (
/obj/structure/table,
/obj/item/coin/mythril,
/turf/open/floor/mineral/titanium,
/area/external/shuttle/station/escape)
"aB" = (
/obj/machinery/door/airlock/public/glass{
	name = "Emergency Shuttle Brig"
	},
/obj/machinery/door/firedoor/border_only{
	dir = 1
	},
/obj/machinery/door/firedoor/border_only,
/obj/effect/mapping_helpers/airlock/access/all/security/basic,
/turf/open/floor/mineral/plastitanium/red/brig,
/area/external/shuttle/station/escape)
"aC" = (
/obj/machinery/door/airlock/titanium,
/obj/machinery/door/firedoor/border_only{
	dir = 1
	},
/obj/machinery/door/firedoor/border_only,
/turf/open/floor/mineral/titanium,
/area/external/shuttle/station/escape)
"aD" = (
/obj/machinery/door/airlock/titanium{
	name = "Emergency Shuttle Airlock"
	},
/obj/docking_port/mobile/emergency{
	name = "NT Lepton Violet"
	},
/obj/machinery/door/firedoor/border_only{
	dir = 4
	},
/obj/machinery/door/firedoor/border_only{
	dir = 8
	},
/turf/open/floor/plating,
/area/external/shuttle/station/escape)
"aE" = (
/obj/machinery/door/window/eastleft,
/obj/structure/window/reinforced{
	dir = 4
	},
/turf/open/floor/mineral/titanium,
/area/external/shuttle/station/escape)
"aF" = (
/obj/machinery/door/window/eastright,
/obj/structure/window/reinforced{
	dir = 4
	},
/turf/open/floor/mineral/titanium,
/area/external/shuttle/station/escape)
"aG" = (
/obj/structure/extinguisher_cabinet{
	pixel_x = 27
	},
/obj/structure/table/glass,
/obj/item/storage/box/syringes{
	pixel_x = 3;
	pixel_y = 3
	},
/obj/item/storage/box/beakers,
/turf/open/floor/mineral/titanium/white,
/area/external/shuttle/station/escape)
"aH" = (
/obj/machinery/status_display/evac,
/turf/closed/wall/mineral/titanium,
/area/external/shuttle/station/escape)
"aI" = (
/obj/structure/chair/comfy/shuttle{
	dir = 4
	},
/turf/open/floor/mineral/titanium/blue,
/area/external/shuttle/station/escape)
"aJ" = (
/obj/structure/chair/comfy/shuttle{
	dir = 8
	},
/obj/structure/window/reinforced{
	dir = 4
	},
/turf/open/floor/mineral/titanium/blue,
/area/external/shuttle/station/escape)
"aL" = (
/obj/structure/table/reinforced,
/turf/open/floor/mineral/titanium,
/area/external/shuttle/station/escape)
"aM" = (
/obj/machinery/chem_dispenser,
/obj/machinery/light/small{
	dir = 4
	},
/turf/open/floor/mineral/titanium/white,
/area/external/shuttle/station/escape)
"aN" = (
/obj/structure/table,
/obj/item/storage/toolbox/mechanical,
/obj/item/storage/firstaid/regular{
	pixel_x = -1;
	pixel_y = 1
	},
/obj/item/wrench/medical,
/turf/open/floor/mineral/titanium/white,
/area/external/shuttle/station/escape)
"aO" = (
/turf/open/floor/plating,
/area/external/shuttle/station/escape)
"aP" = (
/obj/structure/chair/office/light{
	dir = 8
	},
/turf/open/floor/mineral/titanium,
/area/external/shuttle/station/escape)
"aQ" = (
/obj/machinery/chem_heater,
/turf/open/floor/mineral/titanium/white,
/area/external/shuttle/station/escape)
"aR" = (
/obj/machinery/chem_master,
/turf/open/floor/mineral/titanium/white,
/area/external/shuttle/station/escape)
"aT" = (
/obj/structure/table/glass,
/obj/item/reagent_containers/glass/bottle/epinephrine{
	pixel_x = 2;
	pixel_y = 2
	},
/obj/item/reagent_containers/glass/bottle/charcoal,
/turf/open/floor/mineral/titanium/white,
/area/external/shuttle/station/escape)
"aU" = (
/obj/machinery/door/airlock/public/glass,
/obj/machinery/door/firedoor/border_only{
	dir = 1
	},
/obj/machinery/door/firedoor/border_only,
/turf/open/floor/mineral/titanium,
/area/external/shuttle/station/escape)
"aV" = (
/obj/machinery/door/airlock/titanium{
	name = "Emergency Shuttle Airlock"
	},
/obj/machinery/door/firedoor/border_only{
	dir = 4
	},
/obj/machinery/door/firedoor/border_only{
	dir = 8
	},
/turf/open/floor/plating,
/area/external/shuttle/station/escape)
"aW" = (
/obj/effect/turf_decal/stripes/line{
	dir = 1
	},
/obj/effect/turf_decal/tile/yellow{
	dir = 1
	},
/obj/effect/turf_decal/tile/yellow,
/obj/effect/turf_decal/tile/yellow{
	dir = 4
	},
/obj/effect/turf_decal/tile/yellow{
	dir = 8
	},
/turf/open/floor/plasteel,
/area/external/shuttle/station/escape)
"aX" = (
/obj/effect/turf_decal/stripes/line{
	dir = 5
	},
/obj/effect/turf_decal/tile/yellow{
	dir = 1
	},
/obj/effect/turf_decal/tile/yellow,
/obj/effect/turf_decal/tile/yellow{
	dir = 4
	},
/obj/effect/turf_decal/tile/yellow{
	dir = 8
	},
/turf/open/floor/plasteel,
/area/external/shuttle/station/escape)
"aY" = (
/obj/effect/turf_decal/stripes/line{
	dir = 9
	},
/obj/effect/turf_decal/tile/red{
	dir = 1
	},
/obj/effect/turf_decal/tile/red,
/obj/effect/turf_decal/tile/red{
	dir = 4
	},
/obj/effect/turf_decal/tile/red{
	dir = 8
	},
/turf/open/floor/plasteel/white,
/area/external/shuttle/station/escape)
"aZ" = (
/obj/effect/turf_decal/stripes/line{
	dir = 1
	},
/obj/effect/turf_decal/tile/red{
	dir = 1
	},
/obj/effect/turf_decal/tile/red,
/obj/effect/turf_decal/tile/red{
	dir = 4
	},
/obj/effect/turf_decal/tile/red{
	dir = 8
	},
/turf/open/floor/plasteel/white,
/area/external/shuttle/station/escape)
"ba" = (
/obj/structure/destructible/cult/forge{
	desc = "An engine used in powering the shuttle.";
	name = "magma engine"
	},
/obj/effect/turf_decal/tile/yellow{
	dir = 1
	},
/obj/effect/turf_decal/tile/yellow,
/obj/effect/turf_decal/tile/yellow{
	dir = 4
	},
/obj/effect/turf_decal/tile/yellow{
	dir = 8
	},
/obj/machinery/door/firedoor/border_only,
/turf/open/floor/plasteel,
/area/external/shuttle/station/escape)
"bb" = (
/obj/effect/turf_decal/stripes/line{
	dir = 4
	},
/obj/effect/turf_decal/tile/yellow{
	dir = 1
	},
/obj/effect/turf_decal/tile/yellow,
/obj/effect/turf_decal/tile/yellow{
	dir = 4
	},
/obj/effect/turf_decal/tile/yellow{
	dir = 8
	},
/obj/machinery/door/firedoor/border_only,
/turf/open/floor/plasteel,
/area/external/shuttle/station/escape)
"bc" = (
/obj/effect/turf_decal/stripes/line{
	dir = 8
	},
/obj/effect/turf_decal/tile/red{
	dir = 1
	},
/obj/effect/turf_decal/tile/red,
/obj/effect/turf_decal/tile/red{
	dir = 4
	},
/obj/effect/turf_decal/tile/red{
	dir = 8
	},
/obj/machinery/door/firedoor/border_only,
/turf/open/floor/plasteel/white,
/area/external/shuttle/station/escape)
"bd" = (
/obj/structure/destructible/cult/forge{
	desc = "An engine used in powering the shuttle.";
	name = "magma engine"
	},
/obj/effect/turf_decal/tile/red{
	dir = 1
	},
/obj/effect/turf_decal/tile/red,
/obj/effect/turf_decal/tile/red{
	dir = 4
	},
/obj/effect/turf_decal/tile/red{
	dir = 8
	},
/obj/machinery/door/firedoor/border_only,
/turf/open/floor/plasteel/white,
/area/external/shuttle/station/escape)
"be" = (
/obj/structure/window/reinforced{
	dir = 1;
	resistance_flags = 33
	},
/turf/open/lava/smooth/airless,
/area/external/shuttle/station/escape)
"bf" = (
/obj/structure/shuttle/engine/heater,
/turf/open/lava/smooth/airless,
/area/external/shuttle/station/escape)
"bg" = (
/obj/structure/shuttle/engine/propulsion,
/turf/open/floor/plating/airless,
/area/external/shuttle/station/escape)
"bi" = (
/obj/machinery/light,
/obj/effect/turf_decal/tile/green{
	dir = 1
	},
/obj/effect/turf_decal/tile/green,
/obj/effect/turf_decal/tile/green{
	dir = 4
	},
/obj/effect/turf_decal/tile/green{
	dir = 8
	},
/turf/open/floor/plasteel/dark,
/area/external/shuttle/station/escape)
"bj" = (
/obj/machinery/light/small{
	dir = 1
	},
/turf/open/floor/mineral/plastitanium/red/brig,
/area/external/shuttle/station/escape)
"bk" = (
/obj/structure/chair/wood,
/obj/machinery/light{
	dir = 8
	},
/turf/open/floor/plasteel/cult,
/area/external/shuttle/station/escape)
"bl" = (
/obj/machinery/light{
	dir = 1
	},
/turf/open/floor/mineral/titanium,
/area/external/shuttle/station/escape)
"bm" = (
/obj/structure/chair/comfy/shuttle{
	dir = 4
	},
/obj/machinery/light/small{
	dir = 8
	},
/obj/machinery/door/firedoor/border_only{
	dir = 1
	},
/turf/open/floor/mineral/titanium/blue,
/area/external/shuttle/station/escape)
"bn" = (
/obj/machinery/light,
/turf/open/floor/mineral/titanium,
/area/external/shuttle/station/escape)
"bo" = (
/obj/structure/chair/comfy/shuttle{
	dir = 4
	},
/obj/machinery/light/small{
	brightness = 3;
	dir = 8
	},
/turf/open/floor/mineral/titanium/blue,
/area/external/shuttle/station/escape)
"bp" = (
/obj/machinery/light/small{
	dir = 4
	},
/turf/open/floor/mineral/titanium,
/area/external/shuttle/station/escape)
"bM" = (
/obj/machinery/door/firedoor/border_only{
	dir = 4
	},
/turf/open/floor/mineral/titanium,
/area/external/shuttle/station/escape)
"hW" = (
/obj/machinery/door/firedoor/border_only,
/turf/open/floor/mineral/titanium,
/area/external/shuttle/station/escape)
"ji" = (
/obj/structure/chair/comfy/shuttle{
	dir = 8
	},
/turf/open/floor/mineral/titanium/blue,
/area/external/shuttle/station/escape)
"pF" = (
/obj/structure/chair/comfy/shuttle{
	dir = 8
	},
/obj/machinery/door/firedoor/border_only,
/turf/open/floor/mineral/titanium/blue,
/area/external/shuttle/station/escape)
"pM" = (
/obj/structure/chair/comfy/shuttle{
	dir = 8
	},
/obj/structure/window/reinforced{
	dir = 4
	},
/obj/machinery/door/firedoor/border_only{
	dir = 1
	},
/turf/open/floor/mineral/titanium/blue,
/area/external/shuttle/station/escape)
"sc" = (
/obj/structure/chair/comfy/shuttle{
	dir = 8
	},
/obj/structure/window/reinforced{
	dir = 4
	},
/obj/machinery/door/firedoor/border_only,
/turf/open/floor/mineral/titanium/white,
/area/external/shuttle/station/escape)
"sE" = (
/obj/machinery/door/firedoor/border_only,
/obj/machinery/stasis{
	dir = 4
	},
/turf/open/floor/mineral/titanium/white,
/area/external/shuttle/station/escape)
"yZ" = (
/obj/machinery/door/firedoor/border_only{
	dir = 1
	},
/turf/open/floor/mineral/titanium,
/area/external/shuttle/station/escape)
"BZ" = (
/obj/effect/spawner/structure/window/shuttle,
/obj/machinery/door/firedoor/border_only{
	dir = 4
	},
/turf/open/floor/plating,
/area/external/shuttle/station/escape)
"Ec" = (
/obj/structure/chair/comfy/shuttle{
	dir = 8
	},
/obj/structure/window/reinforced{
	dir = 4
	},
/obj/machinery/door/firedoor/border_only{
	dir = 1
	},
/turf/open/floor/mineral/titanium/white,
/area/external/shuttle/station/escape)
"Ep" = (
/obj/effect/spawner/structure/window/shuttle,
/obj/machinery/door/firedoor/border_only{
	dir = 8
	},
/turf/open/floor/plating,
/area/external/shuttle/station/escape)
"ID" = (
/obj/structure/chair/comfy/shuttle{
	dir = 4
	},
/obj/machinery/door/firedoor/border_only,
/turf/open/floor/mineral/titanium/blue,
/area/external/shuttle/station/escape)
"IO" = (
/obj/structure/chair/comfy/shuttle{
	dir = 8
	},
/obj/structure/window/reinforced{
	dir = 4
	},
/obj/machinery/door/firedoor/border_only,
/turf/open/floor/mineral/titanium/blue,
/area/external/shuttle/station/escape)
"MK" = (
/obj/machinery/portable_atmospherics/canister/air,
/turf/open/floor/mineral/titanium/blue,
/area/external/shuttle/station/escape)
"Wh" = (
/obj/machinery/door/firedoor/border_only{
	dir = 1
	},
/obj/machinery/stasis{
	dir = 4
	},
/turf/open/floor/mineral/titanium/white,
/area/external/shuttle/station/escape)

(1,1,1) = {"
aa
aa
aa
aa
ab
ab
ab
ax
ab
aD
ab
Ep
Ep
Ep
ab
aV
ab
aV
ab
ab
ab
aa
"}
(2,1,1) = {"
aa
ab
ab
ab
ab
ak
at
al
as
aq
bm
aI
ID
aq
ab
aq
bo
aW
ba
be
ab
ab
"}
(3,1,1) = {"
ab
ab
ag
ae
ab
bj
al
al
aB
aq
yZ
aq
hW
aq
ab
aq
aq
aX
bb
be
bf
bg
"}
(4,1,1) = {"
ac
ad
ae
ad
ab
am
am
am
as
bM
pM
aJ
IO
bM
aU
aq
aq
aq
hW
be
bf
bg
"}
(5,1,1) = {"
ac
ae
ad
ae
ab
ab
ab
ab
ab
aq
Wh
aN
sE
aq
ab
ji
ji
ji
pF
be
bf
bg
"}
(6,1,1) = {"
ac
af
ad
bi
ai
an
bk
ay
ab
bl
yZ
aq
hW
bn
aH
ab
ab
ab
ab
be
bf
bg
"}
(7,1,1) = {"
ac
ae
ad
ae
aj
ao
au
az
ab
aE
Ec
bM
sc
aF
as
aI
aI
aI
ID
be
bf
bg
"}
(8,1,1) = {"
ac
ad
ae
ad
ai
ap
av
aA
ab
aq
aL
aO
aL
aq
aU
aq
aq
aq
hW
be
bf
bg
"}
(9,1,1) = {"
ab
ab
ah
ae
aH
aq
aq
aq
aC
aq
aq
aP
aq
aq
as
MK
aq
aY
bc
be
bf
bg
"}
(10,1,1) = {"
aa
ab
ab
ab
ab
ar
aw
aw
ab
aG
aM
aQ
aR
aT
as
MK
bp
aZ
bd
be
ab
ab
"}
(11,1,1) = {"
aa
aa
aa
aa
ab
BZ
ab
BZ
ab
ab
ab
BZ
BZ
BZ
ab
ab
ab
BZ
ab
ab
ab
aa
"}
