//MAP CONVERTED BY dmm2tgm.py THIS HEADER COMMENT PREVENTS RECONVERSION, DO NOT REMOVE
"aa" = (
/turf/template_noop,
/area/template_noop)
"ab" = (
/obj/structure/chair/comfy/shuttle,
/obj/machinery/door/firedoor/border_only{
	dir = 4
	},
/obj/structure/sign/warning/nosmoking{
	pixel_y = 32
	},
/turf/open/floor/mineral/titanium/blue,
/area/external/shuttle/station/escape)
"ac" = (
/obj/effect/spawner/structure/window/shuttle,
/turf/open/floor/plating,
/area/external/shuttle/station/escape)
"ad" = (
/turf/closed/wall/mineral/titanium,
/area/external/shuttle/station/escape/custom/meteor)
"ae" = (
/obj/structure/table,
/obj/item/folder/blue,
/obj/structure/extinguisher_cabinet{
	dir = 4;
	pixel_y = -32
	},
/turf/open/floor/mineral/titanium/blue,
/area/external/shuttle/station/escape)
"af" = (
/obj/machinery/door/airlock/titanium{
	name = "Emergency Shuttle Airlock"
	},
/obj/machinery/door/firedoor/border_only{
	dir = 1
	},
/obj/machinery/door/firedoor/border_only,
/turf/open/floor/mineral/titanium/blue,
/area/external/shuttle/station/escape)
"ag" = (
/obj/structure/sign/warning/nosmoking,
/turf/closed/wall/mineral/titanium,
/area/external/shuttle/station/escape)
"ah" = (
/obj/machinery/door/airlock/titanium{
	name = "Emergency Shuttle Airlock"
	},
/obj/docking_port/mobile/emergency{
	dir = 2;
	dwidth = 5;
	height = 14;
	name = "Meta emergency shuttle";
	width = 25
	},
/obj/machinery/door/firedoor/border_only{
	dir = 1
	},
/obj/machinery/door/firedoor/border_only,
/turf/open/floor/mineral/titanium/blue,
/area/external/shuttle/station/escape)
"ai" = (
/obj/structure/chair/comfy/shuttle{
	dir = 4
	},
/obj/effect/decal/cleanable/dirt,
/obj/structure/extinguisher_cabinet{
	pixel_y = 32
	},
/turf/open/floor/plasteel,
/area/external/shuttle/station/escape)
"aj" = (
/obj/structure/chair/comfy/shuttle{
	dir = 8
	},
/obj/machinery/light{
	dir = 4
	},
/obj/structure/reagent_dispensers/peppertank{
	pixel_x = 32
	},
/turf/open/floor/mineral/plastitanium/red/brig,
/area/external/shuttle/station/escape)
"ak" = (
/obj/structure/sink{
	dir = 1;
	icon_state = "sink"
	},
/turf/open/floor/mineral/titanium/white,
/area/external/shuttle/station/escape)
"al" = (
/obj/structure/table,
/obj/item/phone{
	pixel_x = -3;
	pixel_y = 3
	},
/obj/item/cigbutt/cigarbutt{
	pixel_x = 5;
	pixel_y = -1
	},
/turf/open/floor/mineral/titanium/blue,
/area/external/shuttle/station/escape)
"am" = (
/obj/machinery/computer/crew,
/turf/open/floor/mineral/titanium/blue,
/area/external/shuttle/station/escape)
"an" = (
/obj/machinery/computer/security,
/turf/open/floor/mineral/titanium/blue,
/area/external/shuttle/station/escape)
"ao" = (
/obj/structure/table,
/obj/item/storage/firstaid/regular,
/turf/open/floor/mineral/titanium/blue,
/area/external/shuttle/station/escape)
"ap" = (
/obj/structure/closet/emcloset,
/turf/open/floor/mineral/titanium/blue,
/area/external/shuttle/station/escape)
"aq" = (
/turf/open/floor/mineral/titanium/blue,
/area/external/shuttle/station/escape)
"ar" = (
/obj/structure/chair/comfy/shuttle,
/turf/open/floor/mineral/titanium/blue,
/area/external/shuttle/station/escape)
"as" = (
/obj/item/radio/intercom{
	dir = 4;
	name = "Station Intercom (General)";
	pixel_y = 27
	},
/obj/structure/chair/comfy/shuttle,
/obj/machinery/light{
	dir = 1
	},
/turf/open/floor/mineral/titanium/blue,
/area/external/shuttle/station/escape)
"at" = (
/obj/item/clothing/suit/hazardvest{
	desc = "A high-visibility lifejacket complete with whistle and slot for oxygen tanks.";
	name = "emergency lifejacket"
	},
/obj/item/clothing/suit/hazardvest{
	desc = "A high-visibility lifejacket complete with whistle and slot for oxygen tanks.";
	name = "emergency lifejacket"
	},
/obj/item/clothing/suit/hazardvest{
	desc = "A high-visibility lifejacket complete with whistle and slot for oxygen tanks.";
	name = "emergency lifejacket"
	},
/obj/item/clothing/suit/hazardvest{
	desc = "A high-visibility lifejacket complete with whistle and slot for oxygen tanks.";
	name = "emergency lifejacket"
	},
/obj/item/clothing/suit/hazardvest{
	desc = "A high-visibility lifejacket complete with whistle and slot for oxygen tanks.";
	name = "emergency lifejacket"
	},
/obj/item/tank/internals/emergency_oxygen{
	pixel_x = 3
	},
/obj/item/tank/internals/emergency_oxygen{
	pixel_x = 3
	},
/obj/item/tank/internals/emergency_oxygen{
	pixel_x = 3
	},
/obj/item/tank/internals/emergency_oxygen{
	pixel_x = 3
	},
/obj/item/tank/internals/emergency_oxygen{
	pixel_x = 3
	},
/obj/item/clothing/mask/breath{
	pixel_x = -3;
	pixel_y = -3
	},
/obj/item/clothing/mask/breath{
	pixel_x = -3;
	pixel_y = -3
	},
/obj/item/clothing/mask/breath{
	pixel_x = -3;
	pixel_y = -3
	},
/obj/item/clothing/mask/breath{
	pixel_x = -3;
	pixel_y = -3
	},
/obj/item/clothing/mask/breath{
	pixel_x = -3;
	pixel_y = -3
	},
/obj/item/clothing/head/hardhat/orange{
	name = "protective hat";
	pixel_y = 9
	},
/obj/item/clothing/head/hardhat/orange{
	name = "protective hat";
	pixel_y = 9
	},
/obj/item/clothing/head/hardhat/orange{
	name = "protective hat";
	pixel_y = 9
	},
/obj/item/clothing/head/hardhat/orange{
	name = "protective hat";
	pixel_y = 9
	},
/obj/item/clothing/head/hardhat/orange{
	name = "protective hat";
	pixel_y = 9
	},
/obj/structure/closet/crate{
	name = "lifejackets"
	},
/obj/machinery/door/firedoor/border_only,
/turf/open/floor/mineral/titanium/blue,
/area/external/shuttle/station/escape)
"au" = (
/obj/structure/shuttle/engine/propulsion{
	dir = 8
	},
/turf/open/floor/plating/airless,
/area/external/shuttle/station/escape)
"av" = (
/obj/structure/shuttle/engine/heater{
	dir = 8
	},
/obj/structure/window/reinforced{
	dir = 4
	},
/turf/open/floor/plating/airless,
/area/external/shuttle/station/escape)
"aw" = (
/obj/structure/table,
/obj/item/storage/fancy/donut_box,
/turf/open/floor/mineral/titanium/blue,
/area/external/shuttle/station/escape)
"ax" = (
/obj/structure/chair/office/dark{
	dir = 1
	},
/turf/open/floor/mineral/titanium/blue,
/area/external/shuttle/station/escape)
"ay" = (
/obj/structure/table,
/obj/item/restraints/handcuffs{
	pixel_y = 3
	},
/obj/machinery/light{
	dir = 4
	},
/turf/open/floor/mineral/titanium/blue,
/area/external/shuttle/station/escape)
"az" = (
/obj/machinery/status_display/evac,
/turf/closed/wall/mineral/titanium,
/area/external/shuttle/station/escape)
"aA" = (
/obj/structure/tank_dispenser/oxygen{
	layer = 2.7;
	pixel_x = -1;
	pixel_y = 2
	},
/turf/open/floor/mineral/titanium/blue,
/area/external/shuttle/station/escape)
"aB" = (
/obj/machinery/computer/communications/unlocked{
	dir = 4
	},
/turf/open/floor/mineral/titanium/blue,
/area/external/shuttle/station/escape)
"aC" = (
/obj/structure/chair/office/dark,
/turf/open/floor/mineral/titanium/blue,
/area/external/shuttle/station/escape)
"aD" = (
/obj/structure/chair/comfy/shuttle{
	dir = 1
	},
/obj/machinery/door/firedoor/border_only{
	dir = 4
	},
/obj/structure/extinguisher_cabinet{
	pixel_y = -32
	},
/turf/open/floor/mineral/titanium/blue,
/area/external/shuttle/station/escape)
"aE" = (
/obj/structure/chair/comfy/shuttle{
	dir = 1
	},
/turf/open/floor/mineral/titanium/blue,
/area/external/shuttle/station/escape)
"aF" = (
/obj/machinery/computer/emergency_shuttle{
	dir = 4
	},
/turf/open/floor/mineral/titanium/blue,
/area/external/shuttle/station/escape)
"aG" = (
/obj/structure/chair/office/dark{
	dir = 8
	},
/turf/open/floor/mineral/titanium/blue,
/area/external/shuttle/station/escape)
"aH" = (
/obj/machinery/door/airlock/command/glass{
	name = "Cockpit"
	},
/obj/machinery/door/firedoor/border_only{
	dir = 4
	},
/obj/machinery/door/firedoor/border_only{
	dir = 8
	},
/obj/effect/mapping_helpers/airlock/access/all/command/general,
/turf/open/floor/mineral/titanium,
/area/external/shuttle/station/escape)
"aI" = (
/obj/machinery/vending/wallmed{
	name = "Emergency NanoMed";
	use_power = 0
	},
/turf/closed/wall/mineral/titanium,
/area/external/shuttle/station/escape)
"aJ" = (
/obj/structure/extinguisher_cabinet,
/turf/closed/wall/mineral/titanium,
/area/external/shuttle/station/escape)
"aK" = (
/obj/machinery/space_heater,
/obj/effect/turf_decal/bot,
/obj/structure/extinguisher_cabinet{
	pixel_y = -32
	},
/turf/open/floor/plasteel,
/area/external/shuttle/station/escape)
"aL" = (
/obj/machinery/computer/station_alert{
	dir = 4
	},
/turf/open/floor/mineral/titanium/blue,
/area/external/shuttle/station/escape)
"aN" = (
/obj/machinery/status_display/evac{
	dir = 8;
	pixel_x = 32
	},
/obj/machinery/holopad,
/obj/machinery/door/firedoor/border_only{
	dir = 1
	},
/turf/open/floor/mineral/titanium,
/area/external/shuttle/station/escape)
"aO" = (
/obj/structure/table,
/obj/item/storage/toolbox/emergency{
	pixel_y = 3
	},
/turf/open/floor/mineral/titanium/blue,
/area/external/shuttle/station/escape)
"aP" = (
/obj/structure/table,
/obj/machinery/recharger{
	active_power_usage = 0;
	idle_power_usage = 0;
	pixel_y = 4;
	use_power = 0
	},
/turf/open/floor/mineral/titanium/blue,
/area/external/shuttle/station/escape)
"aQ" = (
/obj/structure/table,
/obj/item/paper_bin{
	pixel_x = -2;
	pixel_y = 8
	},
/obj/item/radio/intercom{
	dir = 2;
	name = "Station Intercom (General)";
	pixel_y = -31
	},
/turf/open/floor/mineral/titanium/blue,
/area/external/shuttle/station/escape)
"aS" = (
/obj/item/radio/intercom{
	dir = 2;
	name = "Station Intercom (General)";
	pixel_y = -31
	},
/obj/structure/chair/comfy/shuttle{
	dir = 1
	},
/obj/machinery/light,
/turf/open/floor/mineral/titanium/blue,
/area/external/shuttle/station/escape)
"aT" = (
/obj/structure/table,
/obj/item/stack/medical/gauze,
/obj/item/stack/medical/bruise_pack,
/obj/item/stack/medical/ointment,
/obj/machinery/light{
	dir = 4
	},
/turf/open/floor/mineral/titanium/blue,
/area/external/shuttle/station/escape)
"aW" = (
/obj/machinery/door/airlock/command{
	name = "Emergency Recovery Airlock"
	},
/obj/effect/decal/cleanable/dirt,
/obj/machinery/door/firedoor/border_only{
	dir = 1
	},
/obj/machinery/door/firedoor/border_only,
/obj/effect/mapping_helpers/airlock/access/all/command/general,
/turf/open/floor/plasteel,
/area/external/shuttle/station/escape)
"aY" = (
/obj/machinery/door/airlock/security/glass{
	name = "Brig"
	},
/obj/machinery/door/firedoor/border_only{
	dir = 1
	},
/obj/machinery/door/firedoor/border_only,
/obj/effect/mapping_helpers/airlock/access/all/security/basic,
/turf/open/floor/mineral/plastitanium/red/brig,
/area/external/shuttle/station/escape)
"aZ" = (
/obj/machinery/door/airlock/medical/glass{
	name = "Escape Shuttle Infirmary"
	},
/obj/machinery/door/firedoor/border_only{
	dir = 1
	},
/obj/machinery/door/firedoor/border_only,
/turf/open/floor/mineral/titanium/white,
/area/external/shuttle/station/escape)
"ba" = (
/obj/structure/sign/departments/medbay/alt,
/turf/closed/wall/mineral/titanium,
/area/external/shuttle/station/escape)
"bb" = (
/obj/machinery/door/airlock/titanium{
	name = "Emergency Shuttle Cargo Bay Airlock"
	},
/obj/effect/turf_decal/delivery,
/obj/machinery/door/firedoor/border_only{
	dir = 1
	},
/obj/machinery/door/firedoor/border_only,
/turf/open/floor/plasteel,
/area/external/shuttle/station/escape)
"bd" = (
/obj/structure/chair/comfy/shuttle{
	dir = 4
	},
/obj/effect/decal/cleanable/dirt,
/turf/open/floor/plasteel,
/area/external/shuttle/station/escape)
"be" = (
/obj/effect/decal/cleanable/dirt,
/turf/open/floor/plasteel,
/area/external/shuttle/station/escape)
"bf" = (
/obj/machinery/door/airlock/external{
	name = "Emergency Recovery Airlock"
	},
/obj/effect/decal/cleanable/dirt,
/obj/machinery/door/firedoor/border_only{
	dir = 4
	},
/obj/machinery/door/firedoor/border_only{
	dir = 8
	},
/turf/open/floor/plasteel,
/area/external/shuttle/station/escape)
"bh" = (
/obj/structure/chair/comfy/shuttle{
	dir = 4
	},
/turf/open/floor/mineral/plastitanium/red/brig,
/area/external/shuttle/station/escape)
"bi" = (
/obj/structure/chair/comfy/shuttle,
/turf/open/floor/mineral/plastitanium/red/brig,
/area/external/shuttle/station/escape)
"bj" = (
/obj/structure/table,
/obj/item/defibrillator/loaded,
/turf/open/floor/mineral/titanium,
/area/external/shuttle/station/escape)
"bk" = (
/obj/machinery/shower,
/turf/open/floor/mineral/titanium/white,
/area/external/shuttle/station/escape)
"bm" = (
/obj/structure/rack,
/obj/item/crowbar,
/obj/item/wrench,
/obj/item/weldingtool,
/obj/item/wirecutters,
/obj/item/stack/cable_coil,
/obj/effect/turf_decal/stripes/line{
	dir = 4
	},
/turf/open/floor/plasteel,
/area/external/shuttle/station/escape)
"bn" = (
/obj/structure/reagent_dispensers/watertank,
/obj/effect/turf_decal/delivery,
/turf/open/floor/plasteel,
/area/external/shuttle/station/escape)
"bo" = (
/obj/structure/reagent_dispensers/fueltank,
/obj/effect/turf_decal/delivery,
/obj/machinery/light{
	dir = 1
	},
/turf/open/floor/plasteel,
/area/external/shuttle/station/escape)
"bp" = (
/obj/effect/turf_decal/delivery,
/turf/open/floor/plasteel,
/area/external/shuttle/station/escape)
"bq" = (
/obj/machinery/recharge_station,
/obj/effect/turf_decal/delivery,
/turf/open/floor/plasteel,
/area/external/shuttle/station/escape)
"bs" = (
/obj/structure/chair/comfy/shuttle{
	dir = 8
	},
/turf/open/floor/mineral/plastitanium/red/brig,
/area/external/shuttle/station/escape)
"bu" = (
/obj/structure/table,
/obj/item/reagent_containers/glass/bottle/epinephrine{
	pixel_x = 6
	},
/obj/item/reagent_containers/glass/bottle/charcoal{
	pixel_x = -3
	},
/obj/item/reagent_containers/glass/bottle/epinephrine{
	pixel_x = -3;
	pixel_y = 8
	},
/obj/item/reagent_containers/glass/bottle/charcoal{
	pixel_x = 6;
	pixel_y = 8
	},
/obj/item/reagent_containers/syringe/epinephrine{
	pixel_x = 3;
	pixel_y = -2
	},
/obj/item/reagent_containers/syringe/epinephrine{
	pixel_x = 4;
	pixel_y = 1
	},
/obj/item/reagent_containers/syringe/epinephrine{
	pixel_x = -2;
	pixel_y = 5
	},
/obj/item/reagent_containers/syringe/epinephrine{
	pixel_x = 2;
	pixel_y = 8
	},
/turf/open/floor/mineral/titanium,
/area/external/shuttle/station/escape)
"bv" = (
/obj/structure/rack,
/obj/item/storage/toolbox/electrical{
	pixel_x = -3;
	pixel_y = 1
	},
/obj/item/storage/toolbox/mechanical{
	pixel_y = -1
	},
/obj/item/storage/toolbox/emergency{
	pixel_x = 3;
	pixel_y = -5
	},
/obj/effect/turf_decal/stripes/line{
	dir = 4
	},
/turf/open/floor/plasteel,
/area/external/shuttle/station/escape)
"bw" = (
/obj/item/cigbutt,
/obj/effect/decal/cleanable/dirt,
/turf/open/floor/plasteel,
/area/external/shuttle/station/escape)
"by" = (
/obj/machinery/suit_storage_unit/standard_unit,
/obj/effect/decal/cleanable/dirt,
/turf/open/floor/plasteel,
/area/external/shuttle/station/escape)
"bz" = (
/obj/structure/table/optable,
/obj/item/surgical_drapes,
/obj/machinery/light{
	dir = 8
	},
/turf/open/floor/mineral/titanium,
/area/external/shuttle/station/escape)
"bA" = (
/obj/effect/turf_decal/stripes/line{
	dir = 4
	},
/turf/open/floor/plasteel,
/area/external/shuttle/station/escape)
"bC" = (
/obj/structure/reagent_dispensers/watertank,
/obj/effect/decal/cleanable/dirt,
/turf/open/floor/plasteel,
/area/external/shuttle/station/escape)
"bD" = (
/obj/structure/table,
/obj/item/folder/red{
	pixel_x = 3
	},
/obj/item/folder/white{
	pixel_x = -4;
	pixel_y = 2
	},
/obj/item/radio/intercom{
	dir = 2;
	name = "Station Intercom (General)";
	pixel_y = -31
	},
/obj/item/book/manual/wiki/security_space_law{
	pixel_x = -4;
	pixel_y = 4
	},
/turf/open/floor/mineral/plastitanium/red/brig,
/area/external/shuttle/station/escape)
"bE" = (
/obj/structure/table,
/obj/item/restraints/handcuffs{
	pixel_y = 3
	},
/turf/open/floor/mineral/plastitanium/red/brig,
/area/external/shuttle/station/escape)
"bF" = (
/obj/structure/table,
/obj/machinery/recharger{
	active_power_usage = 0;
	idle_power_usage = 0;
	use_power = 0
	},
/turf/open/floor/mineral/plastitanium/red/brig,
/area/external/shuttle/station/escape)
"bG" = (
/obj/structure/table,
/obj/item/storage/box/handcuffs{
	pixel_x = 2;
	pixel_y = 2
	},
/turf/open/floor/mineral/plastitanium/red/brig,
/area/external/shuttle/station/escape)
"bH" = (
/obj/structure/table,
/obj/item/scalpel{
	pixel_y = 12
	},
/obj/item/circular_saw,
/obj/item/retractor{
	pixel_x = 4
	},
/obj/item/hemostat{
	pixel_x = -4
	},
/obj/item/clothing/gloves/color/latex,
/obj/item/clothing/mask/surgical,
/obj/item/radio/intercom{
	dir = 2;
	name = "Station Intercom (General)";
	pixel_x = -27
	},
/obj/item/surgicaldrill,
/obj/item/cautery,
/turf/open/floor/mineral/titanium,
/area/external/shuttle/station/escape)
"bJ" = (
/obj/structure/table,
/obj/item/storage/firstaid/fire,
/obj/item/storage/firstaid/regular{
	pixel_x = 2;
	pixel_y = 3
	},
/turf/open/floor/mineral/titanium,
/area/external/shuttle/station/escape)
"bK" = (
/obj/structure/table,
/obj/item/storage/firstaid/toxin,
/obj/item/storage/firstaid/o2{
	pixel_x = 3;
	pixel_y = 3
	},
/turf/open/floor/mineral/titanium,
/area/external/shuttle/station/escape)
"bL" = (
/obj/structure/extinguisher_cabinet,
/turf/closed/wall/mineral/titanium/nodiagonal,
/area/external/shuttle/station/escape)
"bM" = (
/obj/structure/rack,
/obj/item/tank/internals/oxygen/red,
/obj/item/clothing/suit/fire/firefighter,
/obj/item/clothing/mask/gas,
/obj/item/clothing/head/hardhat/red,
/obj/effect/turf_decal/stripes/line{
	dir = 4
	},
/turf/open/floor/plasteel,
/area/external/shuttle/station/escape)
"bO" = (
/obj/structure/closet/crate{
	name = "emergency supplies crate"
	},
/obj/item/storage/toolbox/emergency,
/obj/item/storage/toolbox/emergency,
/obj/item/flashlight/flare/signal{
	pixel_x = 3;
	pixel_y = 3
	},
/obj/item/flashlight/flare/signal{
	pixel_x = -6;
	pixel_y = -2
	},
/obj/item/crowbar,
/obj/item/wrench,
/obj/item/radio,
/obj/effect/turf_decal/bot,
/turf/open/floor/plasteel,
/area/external/shuttle/station/escape)
"bP" = (
/obj/structure/closet/crate/medical{
	name = "medical crate"
	},
/obj/item/storage/firstaid/regular,
/obj/item/storage/firstaid/o2{
	pixel_x = 3;
	pixel_y = 3
	},
/obj/item/storage/firstaid/toxin{
	pixel_x = -4;
	pixel_y = 3
	},
/obj/item/healthanalyzer{
	pixel_x = 3;
	pixel_y = 3
	},
/obj/item/lazarus_injector,
/obj/effect/turf_decal/bot,
/mob/living/simple_animal/bot/medbot{
	name = "\improper emergency medibot";
	pixel_x = -3;
	pixel_y = 2
	},
/turf/open/floor/plasteel,
/area/external/shuttle/station/escape)
"bQ" = (
/obj/item/radio/intercom{
	dir = 2;
	name = "Station Intercom (General)";
	pixel_y = -31
	},
/obj/machinery/portable_atmospherics/canister/oxygen,
/obj/effect/turf_decal/bot,
/turf/open/floor/plasteel,
/area/external/shuttle/station/escape)
"bR" = (
/obj/structure/table,
/obj/item/clipboard,
/obj/item/folder/yellow,
/obj/item/pen,
/obj/item/hand_labeler_refill,
/obj/effect/turf_decal/bot,
/turf/open/floor/plasteel,
/area/external/shuttle/station/escape)
"bS" = (
/obj/machinery/vending/wallmed{
	name = "Emergency NanoMed";
	use_power = 0
	},
/turf/closed/wall/mineral/titanium/nodiagonal,
/area/external/shuttle/station/escape)
"bT" = (
/turf/closed/wall/mineral/titanium/nodiagonal,
/area/external/shuttle/station/escape)
"bU" = (
/turf/open/floor/mineral/plastitanium/red/brig,
/area/external/shuttle/station/escape)
"bV" = (
/obj/structure/chair/comfy/shuttle,
/obj/machinery/light{
	dir = 1
	},
/turf/open/floor/mineral/titanium/blue,
/area/external/shuttle/station/escape)
"bW" = (
/obj/item/clothing/suit/hazardvest{
	desc = "A high-visibility lifejacket complete with whistle and slot for oxygen tanks.";
	name = "emergency lifejacket"
	},
/obj/item/clothing/suit/hazardvest{
	desc = "A high-visibility lifejacket complete with whistle and slot for oxygen tanks.";
	name = "emergency lifejacket"
	},
/obj/item/clothing/suit/hazardvest{
	desc = "A high-visibility lifejacket complete with whistle and slot for oxygen tanks.";
	name = "emergency lifejacket"
	},
/obj/item/clothing/suit/hazardvest{
	desc = "A high-visibility lifejacket complete with whistle and slot for oxygen tanks.";
	name = "emergency lifejacket"
	},
/obj/item/clothing/suit/hazardvest{
	desc = "A high-visibility lifejacket complete with whistle and slot for oxygen tanks.";
	name = "emergency lifejacket"
	},
/obj/item/tank/internals/emergency_oxygen{
	pixel_x = 3
	},
/obj/item/tank/internals/emergency_oxygen{
	pixel_x = 3
	},
/obj/item/tank/internals/emergency_oxygen{
	pixel_x = 3
	},
/obj/item/tank/internals/emergency_oxygen{
	pixel_x = 3
	},
/obj/item/tank/internals/emergency_oxygen{
	pixel_x = 3
	},
/obj/item/clothing/mask/breath{
	pixel_x = -3;
	pixel_y = -3
	},
/obj/item/clothing/mask/breath{
	pixel_x = -3;
	pixel_y = -3
	},
/obj/item/clothing/mask/breath{
	pixel_x = -3;
	pixel_y = -3
	},
/obj/item/clothing/mask/breath{
	pixel_x = -3;
	pixel_y = -3
	},
/obj/item/clothing/mask/breath{
	pixel_x = -3;
	pixel_y = -3
	},
/obj/item/clothing/head/hardhat/orange{
	name = "protective hat";
	pixel_y = 9
	},
/obj/item/clothing/head/hardhat/orange{
	name = "protective hat";
	pixel_y = 9
	},
/obj/item/clothing/head/hardhat/orange{
	name = "protective hat";
	pixel_y = 9
	},
/obj/item/clothing/head/hardhat/orange{
	name = "protective hat";
	pixel_y = 9
	},
/obj/item/clothing/head/hardhat/orange{
	name = "protective hat";
	pixel_y = 9
	},
/obj/structure/closet/crate{
	name = "lifejackets"
	},
/obj/machinery/light{
	dir = 4
	},
/turf/open/floor/mineral/titanium/blue,
/area/external/shuttle/station/escape)
"bX" = (
/obj/machinery/light{
	dir = 8
	},
/turf/open/floor/mineral/titanium/blue,
/area/external/shuttle/station/escape)
"bY" = (
/obj/machinery/light{
	dir = 4
	},
/turf/open/floor/mineral/titanium/blue,
/area/external/shuttle/station/escape)
"ca" = (
/obj/structure/chair/comfy/shuttle{
	dir = 1
	},
/obj/machinery/light,
/turf/open/floor/mineral/titanium/blue,
/area/external/shuttle/station/escape)
"cb" = (
/obj/machinery/light/small{
	dir = 4
	},
/obj/effect/decal/cleanable/dirt,
/turf/open/floor/plasteel,
/area/external/shuttle/station/escape)
"cc" = (
/obj/machinery/light{
	dir = 4
	},
/obj/effect/decal/cleanable/dirt,
/turf/open/floor/plasteel,
/area/external/shuttle/station/escape)
"cq" = (
/obj/effect/spawner/structure/window/shuttle,
/obj/machinery/door/firedoor/border_only{
	dir = 1
	},
/turf/open/floor/plating,
/area/external/shuttle/station/escape)
"gu" = (
/obj/machinery/door/airlock/external{
	name = "Emergency Recovery Airlock"
	},
/obj/effect/decal/cleanable/dirt,
/obj/machinery/door/firedoor/border_only{
	dir = 1
	},
/obj/machinery/door/firedoor/border_only,
/turf/open/floor/plasteel,
/area/external/shuttle/station/escape/custom/meteor)
"jK" = (
/obj/effect/turf_decal/delivery,
/obj/machinery/portable_atmospherics/canister/air,
/turf/open/floor/plasteel,
/area/external/shuttle/station/escape)
"ke" = (
/obj/effect/spawner/structure/window/shuttle,
/obj/machinery/door/firedoor/border_only{
	dir = 4
	},
/turf/open/floor/plating,
/area/external/shuttle/station/escape/custom/meteor)
"kA" = (
/obj/machinery/door/firedoor/border_only{
	dir = 1
	},
/turf/open/floor/mineral/titanium/blue,
/area/external/shuttle/station/escape)
"nN" = (
/obj/machinery/door/airlock/medical/glass{
	name = "Escape Shuttle Infirmary"
	},
/obj/machinery/door/firedoor/border_only{
	dir = 4
	},
/obj/machinery/door/firedoor/border_only{
	dir = 8
	},
/turf/open/floor/mineral/titanium/white,
/area/external/shuttle/station/escape)
"pq" = (
/obj/machinery/door/firedoor/border_only,
/turf/open/floor/mineral/titanium/blue,
/area/external/shuttle/station/escape)
"tb" = (
/obj/structure/chair/comfy/shuttle{
	dir = 1
	},
/obj/machinery/door/firedoor/border_only{
	dir = 8
	},
/turf/open/floor/mineral/titanium/blue,
/area/external/shuttle/station/escape)
"yF" = (
/obj/machinery/door/firedoor/border_only{
	dir = 4
	},
/turf/open/floor/mineral/titanium,
/area/external/shuttle/station/escape)
"DP" = (
/obj/machinery/door/firedoor/border_only{
	dir = 1
	},
/turf/open/floor/mineral/titanium,
/area/external/shuttle/station/escape)
"EF" = (
/obj/machinery/door/firedoor/border_only{
	dir = 8
	},
/turf/open/floor/mineral/titanium,
/area/external/shuttle/station/escape)
"LY" = (
/turf/open/floor/mineral/titanium,
/area/external/shuttle/station/escape)
"Ne" = (
/obj/structure/chair/comfy/shuttle{
	dir = 1
	},
/obj/machinery/door/firedoor/border_only{
	dir = 4
	},
/turf/open/floor/mineral/titanium/blue,
/area/external/shuttle/station/escape)
"Np" = (
/obj/machinery/stasis{
	dir = 8
	},
/turf/open/floor/mineral/titanium,
/area/external/shuttle/station/escape)
"Ps" = (
/obj/structure/chair/comfy/shuttle,
/obj/machinery/door/firedoor/border_only{
	dir = 4
	},
/turf/open/floor/mineral/titanium/blue,
/area/external/shuttle/station/escape)
"Rs" = (
/turf/closed/wall/mineral/titanium,
/area/external/shuttle/station/escape)
"Sj" = (
/obj/machinery/door/firedoor/border_only,
/turf/open/floor/mineral/titanium,
/area/external/shuttle/station/escape)
"Vs" = (
/turf/open/floor/mineral/titanium/white,
/area/external/shuttle/station/escape)
"Yb" = (
/obj/effect/spawner/structure/window/shuttle,
/obj/machinery/door/firedoor/border_only,
/turf/open/floor/plating,
/area/external/shuttle/station/escape/custom/meteor)
"Zu" = (
/obj/structure/chair/comfy/shuttle,
/obj/machinery/door/firedoor/border_only{
	dir = 8
	},
/turf/open/floor/mineral/titanium/blue,
/area/external/shuttle/station/escape)

(1,1,1) = {"
aa
aa
au
au
au
Rs
au
au
Rs
au
au
au
aa
aa
"}
(2,1,1) = {"
aa
Rs
av
av
av
Rs
av
av
Rs
av
av
av
Rs
aa
"}
(3,1,1) = {"
Rs
Rs
Rs
Rs
Rs
Rs
Rs
Rs
Rs
Rs
Rs
Rs
Rs
ad
"}
(4,1,1) = {"
cq
al
aw
aB
aF
aL
aO
aP
Rs
ai
bd
bd
bC
Yb
"}
(5,1,1) = {"
cq
am
aq
aG
aG
aG
aq
aQ
Rs
be
cc
be
be
gu
"}
(6,1,1) = {"
cq
an
ax
LY
LY
LY
aC
ae
Rs
bf
bT
be
be
gu
"}
(7,1,1) = {"
cq
ao
ay
LY
LY
LY
bY
aq
aW
cb
Rs
by
by
Yb
"}
(8,1,1) = {"
Rs
Rs
az
Rs
aH
Rs
az
Rs
Rs
Rs
Rs
az
Rs
ad
"}
(9,1,1) = {"
Rs
ap
bX
pq
LY
kA
bX
ap
Rs
bh
bh
bh
bD
ad
"}
(10,1,1) = {"
cq
LY
LY
Sj
LY
DP
LY
LY
aY
bU
bU
bU
bE
Yb
"}
(11,1,1) = {"
Rs
Zu
EF
tb
ac
Zu
EF
tb
ac
bi
bU
bU
bF
Yb
"}
(12,1,1) = {"
af
LY
LY
aE
aI
ar
LY
aE
Rs
bi
aj
bs
bG
ad
"}
(13,1,1) = {"
Rs
bV
LY
aE
ac
ar
LY
aS
Rs
Rs
Rs
az
Rs
ad
"}
(14,1,1) = {"
af
LY
LY
aE
aJ
ar
LY
aE
Rs
bj
bu
bz
bH
ad
"}
(15,1,1) = {"
Rs
ab
yF
Ne
ac
Ps
yF
Ne
ac
bk
Vs
Vs
ak
Yb
"}
(16,1,1) = {"
cq
ar
LY
Sj
LY
DP
LY
LY
aZ
Vs
Vs
Vs
bJ
Yb
"}
(17,1,1) = {"
cq
Zu
EF
tb
ac
Zu
EF
tb
ac
Np
Np
Vs
bK
ad
"}
(18,1,1) = {"
cq
ar
LY
aE
bL
ar
LY
aE
ba
Rs
ac
nN
ba
ad
"}
(19,1,1) = {"
Rs
as
LY
aE
ac
ar
LY
ca
Rs
bm
bv
bA
bM
ad
"}
(20,1,1) = {"
ah
LY
LY
aE
bS
ar
LY
aE
ac
bn
bw
be
aK
ad
"}
(21,1,1) = {"
Rs
Ps
yF
Ne
ac
Ps
yF
aD
Rs
bo
be
be
bO
Yb
"}
(22,1,1) = {"
af
LY
LY
Sj
LY
DP
LY
LY
bb
bp
be
bw
bP
Yb
"}
(23,1,1) = {"
Rs
LY
LY
Sj
LY
DP
LY
LY
bb
bp
be
be
bQ
ad
"}
(24,1,1) = {"
Rs
bW
aA
at
LY
aN
LY
aT
ag
bq
jK
jK
bR
ad
"}
(25,1,1) = {"
ad
ad
ke
ad
ke
ad
ke
ad
ad
ad
ke
ke
ad
ad
"}
