//MAP CONVERTED BY dmm2tgm.py THIS HEADER COMMENT PREVENTS RECONVERSION, DO NOT REMOVE
"a" = (
/turf/template_noop,
/area/template_noop)
"b" = (
/obj/structure/table/reinforced,
/obj/machinery/chem_dispenser/drinks{
	pixel_x = 0;
	pixel_y = 7
	},
/turf/open/floor/plasteel,
/area/template_noop)
"e" = (
/obj/structure/table,
/turf/open/floor/carpet/plaingreen,
/area/template_noop)
"f" = (
/turf/open/floor/carpet/plaingreen,
/area/template_noop)
"g" = (
/turf/closed/wall/mineral/titanium,
/area/template_noop)
"i" = (
/obj/structure/railing{
	dir = 8
	},
/turf/open/floor/plasteel,
/area/template_noop)
"j" = (
/obj/structure/chair/wood{
	dir = 8
	},
/turf/open/floor/plasteel,
/area/template_noop)
"k" = (
/obj/structure/table/wood,
/turf/open/floor/plasteel,
/area/template_noop)
"m" = (
/obj/effect/turf_decal/ramp_corner{
	dir = 1
	},
/turf/open/floor/carpet/plaingreen,
/area/template_noop)
"o" = (
/turf/open/floor/plasteel,
/area/template_noop)
"p" = (
/obj/machinery/door/airlock/maintenance,
/turf/open/floor/plating,
/area/template_noop)
"q" = (
/obj/structure/chair/comfy{
	dir = 8
	},
/obj/effect/turf_decal/ramp_middle{
	dir = 1
	},
/obj/effect/turf_decal/ramp_middle{
	dir = 8
	},
/turf/open/floor/carpet/plaingreen,
/area/template_noop)
"r" = (
/turf/open/floor/plating,
/area/template_noop)
"u" = (
/obj/structure/chair/sofa{
	dir = 1
	},
/obj/effect/turf_decal/ramp_middle{
	dir = 1
	},
/turf/open/floor/carpet/plaingreen,
/area/template_noop)
"v" = (
/obj/structure/window,
/obj/structure/closet/secure_closet/freezer/fridge/open,
/turf/open/floor/plasteel,
/area/template_noop)
"w" = (
/obj/structure/table/wood,
/obj/item/flashlight/lamp/green{
	pixel_x = 1;
	pixel_y = 6
	},
/turf/open/floor/plasteel,
/area/template_noop)
"y" = (
/obj/structure/chair/comfy{
	dir = 8
	},
/turf/open/floor/plasteel,
/area/template_noop)
"z" = (
/obj/effect/turf_decal/ramp_middle{
	dir = 8
	},
/turf/open/floor/carpet/plaingreen,
/area/template_noop)
"A" = (
/obj/structure/railing{
	dir = 9
	},
/turf/open/floor/plasteel,
/area/template_noop)
"D" = (
/obj/structure/chair/comfy,
/turf/open/floor/carpet/plaingreen,
/area/template_noop)
"H" = (
/turf/open/floor/plasteel/stairs/goon/stairs2_wide{
	dir = 4
	},
/area/template_noop)
"I" = (
/obj/structure/railing/corner{
	dir = 8
	},
/turf/open/floor/plasteel,
/area/template_noop)
"J" = (
/obj/structure/chair/wood{
	dir = 4
	},
/turf/open/floor/plasteel,
/area/template_noop)
"L" = (
/turf/open/floor/plasteel/white,
/area/template_noop)
"M" = (
/obj/structure/chair/sofa/left{
	dir = 4
	},
/turf/open/floor/carpet/plaingreen,
/area/template_noop)
"O" = (
/obj/structure/table/reinforced,
/obj/machinery/coffeemaker/impressa{
	pixel_x = 2;
	pixel_y = 7
	},
/turf/open/floor/plasteel,
/area/template_noop)
"P" = (
/obj/structure/table/reinforced,
/turf/open/floor/plasteel,
/area/template_noop)
"Q" = (
/obj/machinery/door/airlock/medical,
/turf/open/floor/plating,
/area/template_noop)
"S" = (
/turf/open/floor/plasteel/stairs/goon/stairs_wide{
	dir = 4
	},
/area/template_noop)
"T" = (
/obj/structure/chair/sofa/corner{
	dir = 4
	},
/obj/effect/turf_decal/ramp_middle{
	dir = 1
	},
/turf/open/floor/carpet/plaingreen,
/area/template_noop)
"U" = (
/obj/structure/chair/sofa/left{
	dir = 1
	},
/obj/effect/turf_decal/ramp_middle{
	dir = 1
	},
/obj/effect/turf_decal/ramp_middle{
	dir = 8
	},
/turf/open/floor/carpet/plaingreen,
/area/template_noop)
"W" = (
/obj/structure/railing{
	dir = 1
	},
/turf/open/floor/plasteel,
/area/template_noop)
"X" = (
/obj/structure/window,
/turf/open/floor/plasteel,
/area/template_noop)

(1,1,1) = {"
a
a
a
a
a
a
a
a
a
a
a
a
a
a
a
a
a
a
a
a
a
a
a
a
a
a
a
a
a
a
a
a
a
a
a
a
a
a
a
a
a
a
a
a
a
a
a
a
a
a
"}
(2,1,1) = {"
a
a
a
a
a
a
a
a
a
a
a
a
a
a
a
a
a
a
a
a
a
a
a
a
a
a
a
a
a
a
a
a
a
a
a
a
a
a
a
a
a
a
a
a
a
a
a
a
a
a
"}
(3,1,1) = {"
a
a
a
a
a
a
a
a
a
a
a
a
a
a
a
a
a
a
a
a
a
a
a
a
a
a
a
a
a
a
a
a
a
a
a
a
a
a
a
a
a
a
a
a
a
a
a
a
a
a
"}
(4,1,1) = {"
a
a
a
a
a
a
a
a
a
a
a
a
a
a
a
a
a
a
a
a
a
a
a
a
a
a
a
a
a
a
a
a
a
a
a
a
a
a
a
a
a
a
a
a
a
a
a
a
a
a
"}
(5,1,1) = {"
a
a
a
a
a
a
a
a
a
a
a
a
a
a
a
a
a
a
a
a
a
a
a
a
a
a
a
a
a
a
a
a
a
a
a
a
a
a
a
a
a
a
a
a
a
a
a
a
a
a
"}
(6,1,1) = {"
a
a
a
a
a
a
a
a
a
a
a
a
a
a
a
a
a
a
a
a
a
a
a
a
a
a
a
a
a
a
a
a
a
a
a
a
a
a
a
a
a
a
a
a
a
a
a
a
a
a
"}
(7,1,1) = {"
a
a
a
a
a
a
a
a
a
a
a
a
a
a
a
a
a
a
a
a
a
a
a
a
a
a
a
a
a
a
a
a
a
a
a
a
a
a
a
a
a
a
a
a
a
a
a
a
a
a
"}
(8,1,1) = {"
a
a
a
a
a
a
a
a
a
a
a
a
a
a
a
a
a
a
a
a
a
a
a
a
a
a
a
a
a
a
a
a
a
a
a
a
a
a
a
a
a
a
a
a
a
a
a
a
a
a
"}
(9,1,1) = {"
a
a
a
a
a
a
a
a
a
a
a
a
a
a
a
a
a
a
a
a
a
a
a
a
a
a
a
a
a
a
a
a
a
a
a
a
a
a
a
a
a
a
a
a
a
a
a
a
a
a
"}
(10,1,1) = {"
a
a
a
a
a
a
a
a
a
a
a
a
a
a
a
a
a
a
a
a
a
a
a
a
a
a
a
a
a
a
a
a
a
a
a
a
a
a
a
a
a
a
a
a
a
a
a
a
a
a
"}
(11,1,1) = {"
a
a
a
a
a
a
a
a
a
a
a
a
a
a
a
a
a
a
a
a
a
a
a
a
a
a
a
a
a
a
a
a
a
a
a
a
a
a
a
a
a
a
a
a
a
a
a
a
a
a
"}
(12,1,1) = {"
a
a
a
a
a
a
a
a
a
a
a
a
a
a
a
a
a
a
a
a
a
a
a
a
a
a
a
a
a
a
a
a
a
a
a
a
a
a
a
a
a
a
a
a
a
a
a
a
a
a
"}
(13,1,1) = {"
a
a
a
a
a
a
a
a
a
a
a
g
g
g
g
g
g
g
g
g
g
g
g
g
a
a
a
a
a
a
a
a
a
a
a
a
a
a
a
a
a
a
a
a
a
a
a
a
a
a
"}
(14,1,1) = {"
a
a
a
a
a
a
a
a
a
a
g
g
f
f
M
T
W
o
o
o
o
o
o
g
a
a
a
a
a
a
a
a
a
a
a
a
a
a
a
a
a
a
a
a
a
a
a
a
a
a
"}
(15,1,1) = {"
a
a
a
a
a
a
a
a
a
a
g
D
f
f
e
u
W
o
o
o
o
o
o
g
r
r
a
a
a
a
a
a
a
a
a
a
a
a
a
a
a
a
a
a
a
a
a
a
a
a
"}
(16,1,1) = {"
a
a
a
a
a
a
a
a
a
a
g
e
f
f
e
u
W
o
o
o
o
o
o
g
r
r
a
a
a
a
a
a
a
a
a
a
a
a
a
a
a
a
a
a
a
a
a
a
a
a
"}
(17,1,1) = {"
a
a
a
a
a
a
a
a
a
a
g
D
f
f
f
u
W
o
J
J
J
o
o
g
r
r
a
a
a
a
a
a
a
a
a
a
a
a
a
a
a
a
a
a
a
a
a
a
a
a
"}
(18,1,1) = {"
a
a
a
a
a
a
a
a
a
a
g
f
f
f
m
U
W
o
k
w
k
o
o
p
r
r
a
a
a
a
a
a
a
a
a
a
a
a
a
a
a
a
a
a
a
a
a
a
a
a
"}
(19,1,1) = {"
a
a
a
a
a
a
a
a
a
a
g
z
z
z
q
A
I
o
j
j
j
o
o
g
r
r
a
a
a
a
a
a
a
a
a
a
a
a
a
a
a
a
a
a
a
a
a
a
a
a
"}
(20,1,1) = {"
a
a
a
a
a
a
a
a
a
a
g
i
S
H
i
I
o
o
o
o
o
o
o
g
r
r
a
a
a
a
a
a
a
a
a
a
a
a
a
a
a
a
a
a
a
a
a
a
a
a
"}
(21,1,1) = {"
a
a
a
a
a
a
a
a
a
a
g
o
o
o
o
o
P
P
P
P
X
o
o
g
a
a
a
a
a
a
a
a
a
a
a
a
a
a
a
a
a
a
a
a
a
a
a
a
a
a
"}
(22,1,1) = {"
a
a
a
a
a
a
a
a
a
a
g
o
o
o
o
o
P
o
o
o
X
o
o
g
a
a
a
a
a
a
a
a
a
a
a
a
a
a
a
a
a
a
a
a
a
a
a
a
a
a
"}
(23,1,1) = {"
a
a
a
a
a
a
a
a
a
a
g
o
o
o
o
o
P
P
O
b
v
y
k
g
a
a
a
a
a
a
a
a
a
a
a
a
a
a
a
a
a
a
a
a
a
a
a
a
a
a
"}
(24,1,1) = {"
a
a
a
a
a
a
a
a
a
a
g
o
o
o
o
o
g
g
g
g
g
g
g
g
a
a
a
a
a
a
a
a
a
a
a
a
a
a
a
a
a
a
a
a
a
a
a
a
a
a
"}
(25,1,1) = {"
a
a
a
a
a
a
a
a
a
a
g
g
g
g
p
g
g
a
a
a
a
a
a
a
a
a
a
a
a
a
a
a
a
a
a
a
a
a
a
a
a
a
a
a
a
a
a
a
a
a
"}
(26,1,1) = {"
a
a
a
a
a
a
a
a
a
a
a
r
r
r
r
r
r
a
a
a
a
a
a
a
a
a
a
a
a
a
a
a
a
a
a
a
a
a
a
a
a
a
a
a
a
a
a
a
a
a
"}
(27,1,1) = {"
a
a
a
a
a
a
a
a
a
a
a
r
r
r
r
r
r
a
a
a
a
a
a
a
a
a
a
a
a
a
a
a
a
a
a
a
a
a
a
a
a
a
a
a
a
a
a
a
a
a
"}
(28,1,1) = {"
a
a
a
a
a
a
a
a
a
a
a
g
g
g
r
r
g
g
g
a
a
a
a
a
a
a
a
a
a
a
a
a
a
a
a
a
a
a
a
a
a
a
a
a
a
a
a
a
a
a
"}
(29,1,1) = {"
a
a
a
a
a
a
a
a
a
a
a
a
a
g
r
r
g
a
a
a
a
a
a
a
a
a
a
a
a
a
a
a
a
a
a
a
a
a
a
a
a
a
a
a
a
a
a
a
a
a
"}
(30,1,1) = {"
a
a
a
a
a
a
a
a
a
a
a
a
a
g
r
r
g
a
a
a
a
a
a
a
a
a
a
a
a
a
a
a
a
a
a
a
a
a
a
a
a
a
a
a
a
a
a
a
a
a
"}
(31,1,1) = {"
a
a
a
a
a
a
a
a
a
a
a
a
g
g
Q
Q
g
a
a
a
a
a
a
a
a
a
a
a
a
a
a
a
a
a
a
a
a
a
a
a
a
a
a
a
a
a
a
a
a
a
"}
(32,1,1) = {"
a
a
a
a
a
a
a
a
a
a
a
a
g
L
L
L
L
L
a
a
a
a
a
a
a
a
a
a
a
a
a
a
a
a
a
a
a
a
a
a
a
a
a
a
a
a
a
a
a
a
"}
(33,1,1) = {"
a
a
a
a
a
a
a
a
a
a
a
a
g
L
L
L
L
L
a
a
a
a
a
a
a
a
a
a
a
a
a
a
a
a
a
a
a
a
a
a
a
a
a
a
a
a
a
a
a
a
"}
(34,1,1) = {"
a
a
a
a
a
a
a
a
a
a
a
a
g
L
L
L
L
L
a
a
a
a
a
a
a
a
a
a
a
a
a
a
a
a
a
a
a
a
a
a
a
a
a
a
a
a
a
a
a
a
"}
(35,1,1) = {"
a
a
a
a
a
a
a
a
a
a
a
a
g
L
L
L
L
L
a
a
a
a
a
a
a
a
a
a
a
a
a
a
a
a
a
a
a
a
a
a
a
a
a
a
a
a
a
a
a
a
"}
(36,1,1) = {"
a
a
a
a
a
a
a
a
a
a
a
a
g
g
g
g
a
a
a
a
a
a
a
a
a
a
a
a
a
a
a
a
a
a
a
a
a
a
a
a
a
a
a
a
a
a
a
a
a
a
"}
(37,1,1) = {"
a
a
a
a
a
a
a
a
a
a
a
a
a
a
a
a
a
a
a
a
a
a
a
a
a
a
a
a
a
a
a
a
a
a
a
a
a
a
a
a
a
a
a
a
a
a
a
a
a
a
"}
(38,1,1) = {"
a
a
a
a
a
a
a
a
a
a
a
a
a
a
a
a
a
a
a
a
a
a
a
a
a
a
a
a
a
a
a
a
a
a
a
a
a
a
a
a
a
a
a
a
a
a
a
a
a
a
"}
(39,1,1) = {"
a
a
a
a
a
a
a
a
a
a
a
a
a
a
a
a
a
a
a
a
a
a
a
a
a
a
a
a
a
a
a
a
a
a
a
a
a
a
a
a
a
a
a
a
a
a
a
a
a
a
"}
(40,1,1) = {"
a
a
a
a
a
a
a
a
a
a
a
a
a
a
a
a
a
a
a
a
a
a
a
a
a
a
a
a
a
a
a
a
a
a
a
a
a
a
a
a
a
a
a
a
a
a
a
a
a
a
"}
(41,1,1) = {"
a
a
a
a
a
a
a
a
a
a
a
a
a
a
a
a
a
a
a
a
a
a
a
a
a
a
a
a
a
a
a
a
a
a
a
a
a
a
a
a
a
a
a
a
a
a
a
a
a
a
"}
(42,1,1) = {"
a
a
a
a
a
a
a
a
a
a
a
a
a
a
a
a
a
a
a
a
a
a
a
a
a
a
a
a
a
a
a
a
a
a
a
a
a
a
a
a
a
a
a
a
a
a
a
a
a
a
"}
(43,1,1) = {"
a
a
a
a
a
a
a
a
a
a
a
a
a
a
a
a
a
a
a
a
a
a
a
a
a
a
a
a
a
a
a
a
a
a
a
a
a
a
a
a
a
a
a
a
a
a
a
a
a
a
"}
(44,1,1) = {"
a
a
a
a
a
a
a
a
a
a
a
a
a
a
a
a
a
a
a
a
a
a
a
a
a
a
a
a
a
a
a
a
a
a
a
a
a
a
a
a
a
a
a
a
a
a
a
a
a
a
"}
(45,1,1) = {"
a
a
a
a
a
a
a
a
a
a
a
a
a
a
a
a
a
a
a
a
a
a
a
a
a
a
a
a
a
a
a
a
a
a
a
a
a
a
a
a
a
a
a
a
a
a
a
a
a
a
"}
(46,1,1) = {"
a
a
a
a
a
a
a
a
a
a
a
a
a
a
a
a
a
a
a
a
a
a
a
a
a
a
a
a
a
a
a
a
a
a
a
a
a
a
a
a
a
a
a
a
a
a
a
a
a
a
"}
(47,1,1) = {"
a
a
a
a
a
a
a
a
a
a
a
a
a
a
a
a
a
a
a
a
a
a
a
a
a
a
a
a
a
a
a
a
a
a
a
a
a
a
a
a
a
a
a
a
a
a
a
a
a
a
"}
(48,1,1) = {"
a
a
a
a
a
a
a
a
a
a
a
a
a
a
a
a
a
a
a
a
a
a
a
a
a
a
a
a
a
a
a
a
a
a
a
a
a
a
a
a
a
a
a
a
a
a
a
a
a
a
"}
(49,1,1) = {"
a
a
a
a
a
a
a
a
a
a
a
a
a
a
a
a
a
a
a
a
a
a
a
a
a
a
a
a
a
a
a
a
a
a
a
a
a
a
a
a
a
a
a
a
a
a
a
a
a
a
"}
(50,1,1) = {"
a
a
a
a
a
a
a
a
a
a
a
a
a
a
a
a
a
a
a
a
a
a
a
a
a
a
a
a
a
a
a
a
a
a
a
a
a
a
a
a
a
a
a
a
a
a
a
a
a
a
"}
