//MAP CONVERTED BY dmm2tgm.py THIS HEADER COMMENT PREVENTS RECONVERSION, DO NOT REMOVE
"aa" = (
/turf/template_noop,
/area/template_noop)
"ab" = (
/turf/closed/wall/mineral/titanium,
/area/external/shuttle/station/escape)
"ac" = (
/obj/effect/spawner/structure/window/shuttle,
/turf/open/floor/plating,
/area/external/shuttle/station/escape)
"ad" = (
/turf/closed/wall/mineral/titanium/nodiagonal,
/area/external/shuttle/station/escape)
"ae" = (
/obj/structure/table/wood,
/turf/open/floor/carpet,
/area/external/shuttle/station/escape)
"af" = (
/obj/structure/chair/comfy/brown{
	dir = 1
	},
/turf/open/floor/carpet,
/area/external/shuttle/station/escape)
"ag" = (
/obj/machinery/computer/emergency_shuttle,
/turf/open/floor/carpet,
/area/external/shuttle/station/escape)
"ah" = (
/obj/effect/spawner/structure/window/shuttle,
/obj/machinery/door/firedoor/border_only{
	dir = 1
	},
/obj/machinery/door/firedoor/border_only{
	dir = 4
	},
/turf/open/floor/plating,
/area/external/shuttle/station/escape)
"ai" = (
/obj/machinery/computer/atmos_alert{
	dir = 4
	},
/turf/open/floor/carpet,
/area/external/shuttle/station/escape)
"aj" = (
/obj/structure/chair/comfy/brown{
	dir = 8
	},
/turf/open/floor/carpet,
/area/external/shuttle/station/escape)
"ak" = (
/turf/open/floor/carpet,
/area/external/shuttle/station/escape)
"al" = (
/obj/structure/table/wood,
/obj/structure/window/reinforced{
	dir = 4
	},
/obj/machinery/door/firedoor/border_only{
	dir = 4
	},
/turf/open/floor/carpet,
/area/external/shuttle/station/escape)
"am" = (
/obj/machinery/computer/crew{
	dir = 4
	},
/turf/open/floor/carpet,
/area/external/shuttle/station/escape)
"an" = (
/obj/item/radio/intercom{
	name = "Station Intercom (General)";
	pixel_y = -29
	},
/turf/open/floor/carpet,
/area/external/shuttle/station/escape)
"ao" = (
/obj/machinery/button/flasher{
	id = "cockpit_flasher";
	pixel_x = 6;
	pixel_y = -24
	},
/obj/structure/table/wood/poker,
/obj/machinery/light,
/turf/open/floor/carpet,
/area/external/shuttle/station/escape)
"ap" = (
/obj/structure/chair/comfy/brown{
	dir = 4
	},
/obj/structure/window/reinforced{
	dir = 4
	},
/obj/structure/window/reinforced,
/obj/machinery/door/firedoor/border_only,
/obj/machinery/door/firedoor/border_only{
	dir = 4
	},
/turf/open/floor/carpet,
/area/external/shuttle/station/escape)
"aq" = (
/obj/machinery/door/airlock/titanium{
	name = "Emergency Shuttle Airlock"
	},
/obj/machinery/door/firedoor/border_only{
	dir = 1
	},
/obj/machinery/door/firedoor/border_only,
/obj/effect/mapping_helpers/airlock/access/all/security/basic,
/turf/open/floor/mineral/plastitanium/red/brig,
/area/external/shuttle/station/escape)
"ar" = (
/obj/machinery/door/airlock/public/glass{
	name = "Emergency Shuttle Cockpit"
	},
/obj/machinery/door/firedoor/border_only{
	dir = 1
	},
/obj/machinery/door/firedoor/border_only,
/obj/effect/mapping_helpers/airlock/access/all/command/general,
/turf/open/floor/carpet,
/area/external/shuttle/station/escape)
"as" = (
/obj/machinery/door/airlock/titanium{
	name = "Emergency Shuttle Airlock"
	},
/obj/machinery/door/firedoor/border_only,
/obj/machinery/door/firedoor/border_only{
	dir = 1
	},
/obj/effect/mapping_helpers/airlock/access/all/security/basic,
/turf/open/floor/mineral/titanium,
/area/external/shuttle/station/escape)
"at" = (
/obj/structure/chair/comfy/shuttle,
/turf/open/floor/mineral/plastitanium/red/brig,
/area/external/shuttle/station/escape)
"au" = (
/obj/machinery/flasher{
	id = "cockpit_flasher";
	pixel_x = 6;
	pixel_y = 24
	},
/obj/effect/turf_decal/tile/bar,
/obj/effect/turf_decal/tile/bar{
	dir = 1
	},
/turf/open/floor/plasteel,
/area/external/shuttle/station/escape)
"av" = (
/obj/effect/turf_decal/tile/bar,
/obj/effect/turf_decal/tile/bar{
	dir = 1
	},
/turf/open/floor/plasteel,
/area/external/shuttle/station/escape)
"aw" = (
/turf/open/floor/mineral/titanium,
/area/external/shuttle/station/escape)
"ax" = (
/obj/machinery/flasher{
	id = "shuttle_flasher";
	pixel_x = -24;
	pixel_y = 6
	},
/obj/machinery/button/flasher{
	id = "shuttle_flasher";
	pixel_x = -24;
	pixel_y = -6
	},
/obj/machinery/light/small{
	brightness = 3;
	dir = 8
	},
/turf/open/floor/mineral/plastitanium/red/brig,
/area/external/shuttle/station/escape)
"ay" = (
/turf/open/floor/mineral/plastitanium/red/brig,
/area/external/shuttle/station/escape)
"az" = (
/obj/structure/grille,
/obj/machinery/door/airlock/public/glass{
	name = "Emergency Shuttle Brig"
	},
/obj/machinery/door/firedoor/border_only{
	dir = 4
	},
/obj/machinery/door/firedoor/border_only{
	dir = 8
	},
/obj/effect/mapping_helpers/airlock/access/all/security/basic,
/turf/open/floor/plating,
/area/external/shuttle/station/escape)
"aA" = (
/obj/structure/grille/broken,
/obj/machinery/door/firedoor/border_only,
/turf/open/floor/plasteel,
/area/external/shuttle/station/escape)
"aB" = (
/turf/closed/wall/mineral/titanium/interior,
/area/external/shuttle/station/escape)
"aC" = (
/obj/machinery/door/airlock/titanium{
	name = "Emergency Shuttle Airlock"
	},
/obj/machinery/door/firedoor/border_only{
	dir = 4
	},
/obj/machinery/door/firedoor/border_only{
	dir = 8
	},
/obj/effect/mapping_helpers/airlock/access/all/security/basic,
/turf/open/floor/plating,
/area/external/shuttle/station/escape)
"aD" = (
/obj/structure/extinguisher_cabinet{
	pixel_y = -30
	},
/obj/structure/table,
/obj/item/extinguisher,
/obj/item/crowbar,
/turf/open/floor/mineral/plastitanium/red/brig,
/area/external/shuttle/station/escape)
"aE" = (
/obj/structure/chair/comfy/shuttle{
	dir = 1
	},
/turf/open/floor/mineral/plastitanium/red/brig,
/area/external/shuttle/station/escape)
"aF" = (
/obj/item/kirbyplants/random,
/turf/open/floor/mineral/titanium/blue,
/area/external/shuttle/station/escape)
"aG" = (
/obj/structure/chair/comfy/shuttle,
/turf/open/floor/mineral/titanium/blue,
/area/external/shuttle/station/escape)
"aH" = (
/obj/structure/chair/comfy/shuttle,
/obj/machinery/light{
	dir = 1
	},
/turf/open/floor/mineral/titanium/blue,
/area/external/shuttle/station/escape)
"aI" = (
/obj/structure/window/reinforced{
	dir = 4
	},
/obj/machinery/door/firedoor/border_only{
	dir = 4
	},
/turf/open/floor/carpet,
/area/external/shuttle/station/escape)
"aJ" = (
/obj/effect/spawner/structure/window/shuttle,
/obj/machinery/door/firedoor/border_only{
	dir = 4
	},
/obj/machinery/door/firedoor/border_only{
	dir = 1
	},
/turf/open/floor/plating,
/area/external/shuttle/station/escape)
"aK" = (
/obj/machinery/door/airlock/titanium{
	name = "Emergency Shuttle Airlock"
	},
/obj/docking_port/mobile/emergency{
	name = "Scrapheap Challenge"
	},
/obj/machinery/door/firedoor/border_only{
	dir = 4
	},
/obj/machinery/door/firedoor/border_only{
	dir = 8
	},
/turf/open/floor/plating,
/area/external/shuttle/station/escape)
"aL" = (
/obj/structure/chair/comfy/shuttle{
	dir = 1
	},
/turf/open/floor/mineral/titanium/blue,
/area/external/shuttle/station/escape)
"aM" = (
/obj/effect/spawner/structure/window/shuttle,
/obj/machinery/door/firedoor/border_only{
	dir = 4
	},
/turf/open/floor/plating,
/area/external/shuttle/station/escape)
"aN" = (
/obj/structure/table/wood,
/obj/item/toy/cards/deck/cas/black,
/turf/open/floor/mineral/titanium/blue,
/area/external/shuttle/station/escape)
"aO" = (
/obj/structure/table/wood,
/turf/open/floor/mineral/titanium/blue,
/area/external/shuttle/station/escape)
"aP" = (
/obj/structure/table/wood,
/obj/item/toy/cards/deck/cas,
/turf/open/floor/mineral/titanium,
/area/external/shuttle/station/escape)
"aQ" = (
/obj/structure/chair/comfy/brown{
	dir = 8
	},
/turf/open/floor/mineral/titanium,
/area/external/shuttle/station/escape)
"aR" = (
/obj/structure/table_frame,
/turf/open/floor/mineral/titanium/blue,
/area/external/shuttle/station/escape)
"aS" = (
/obj/structure/table/wood,
/obj/item/storage/firstaid/fire,
/turf/open/floor/mineral/titanium/blue,
/area/external/shuttle/station/escape)
"aT" = (
/obj/structure/chair/comfy/shuttle{
	dir = 1
	},
/obj/structure/extinguisher_cabinet{
	pixel_y = -30
	},
/turf/open/floor/mineral/titanium/blue,
/area/external/shuttle/station/escape)
"aU" = (
/turf/open/floor/mineral/titanium/blue,
/area/external/shuttle/station/escape)
"aV" = (
/obj/structure/table,
/obj/item/storage/firstaid/regular,
/turf/open/floor/mineral/titanium/blue,
/area/external/shuttle/station/escape)
"aW" = (
/obj/structure/window/reinforced{
	dir = 4
	},
/obj/item/radio/intercom{
	name = "Station Intercom (General)";
	pixel_y = 23
	},
/obj/machinery/door/firedoor/border_only{
	dir = 4
	},
/turf/open/floor/mineral/titanium/blue,
/area/external/shuttle/station/escape)
"aX" = (
/obj/machinery/door/firedoor/border_only,
/turf/open/floor/plasteel/grimy,
/area/external/shuttle/station/escape)
"aY" = (
/obj/structure/chair/wood{
	dir = 1
	},
/obj/machinery/door/firedoor/border_only,
/turf/open/floor/plasteel/grimy,
/area/external/shuttle/station/escape)
"aZ" = (
/obj/machinery/door/airlock/titanium{
	name = "Emergency Shuttle Airlock"
	},
/obj/machinery/door/firedoor/border_only{
	dir = 4
	},
/obj/machinery/door/firedoor/border_only{
	dir = 8
	},
/turf/open/floor/plating,
/area/external/shuttle/station/escape)
"ba" = (
/obj/structure/extinguisher_cabinet{
	pixel_y = -30
	},
/obj/effect/turf_decal/tile/bar,
/obj/effect/turf_decal/tile/bar{
	dir = 1
	},
/turf/open/floor/plasteel,
/area/external/shuttle/station/escape)
"bb" = (
/obj/structure/window/reinforced{
	dir = 4
	},
/obj/structure/barricade/wooden,
/obj/machinery/light,
/obj/effect/turf_decal/tile/bar,
/obj/effect/turf_decal/tile/bar{
	dir = 1
	},
/obj/machinery/door/firedoor/border_only{
	dir = 4
	},
/turf/open/floor/plasteel,
/area/external/shuttle/station/escape)
"bc" = (
/obj/machinery/status_display/evac,
/turf/closed/wall/mineral/titanium,
/area/external/shuttle/station/escape)
"bd" = (
/obj/machinery/door/airlock{
	name = "Unisex Restrooms"
	},
/obj/machinery/door/firedoor/border_only{
	dir = 1
	},
/obj/machinery/door/firedoor/border_only,
/turf/open/floor/plasteel/freezer,
/area/external/shuttle/station/escape)
"be" = (
/turf/open/floor/plasteel/freezer,
/area/external/shuttle/station/escape)
"bf" = (
/obj/structure/extinguisher_cabinet{
	pixel_y = 30
	},
/obj/machinery/light/small{
	dir = 1
	},
/turf/open/floor/plasteel/freezer,
/area/external/shuttle/station/escape)
"bg" = (
/obj/machinery/door/airlock{
	name = "Unit 1"
	},
/obj/machinery/door/firedoor/border_only{
	dir = 1
	},
/obj/machinery/door/firedoor/border_only,
/turf/open/floor/plasteel/freezer,
/area/external/shuttle/station/escape)
"bh" = (
/obj/machinery/door/airlock{
	name = "Unit 2"
	},
/obj/machinery/door/firedoor/border_only{
	dir = 1
	},
/obj/machinery/door/firedoor/border_only,
/turf/open/floor/plasteel/freezer,
/area/external/shuttle/station/escape)
"bi" = (
/obj/machinery/door/firedoor/border_only{
	dir = 1
	},
/obj/machinery/door/firedoor/border_only,
/obj/machinery/door/airlock{
	name = "Unit 3"
	},
/turf/open/floor/plasteel/freezer,
/area/external/shuttle/station/escape)
"bj" = (
/obj/machinery/light/small{
	dir = 4
	},
/obj/structure/toilet{
	dir = 1
	},
/turf/open/floor/plasteel/freezer,
/area/external/shuttle/station/escape)
"bk" = (
/obj/machinery/recharge_station,
/obj/machinery/light/small{
	dir = 4
	},
/turf/open/floor/plasteel/freezer,
/area/external/shuttle/station/escape)
"bl" = (
/obj/structure/window/reinforced{
	dir = 1
	},
/obj/structure/shuttle/engine/heater,
/turf/open/floor/plating/airless,
/area/external/shuttle/station/escape)
"bm" = (
/obj/structure/window/reinforced{
	dir = 1
	},
/obj/structure/shuttle/engine/heater,
/obj/structure/window/reinforced{
	dir = 4
	},
/turf/open/floor/plating/airless,
/area/external/shuttle/station/escape)
"bn" = (
/obj/structure/shuttle/engine/propulsion,
/turf/open/floor/plating/airless,
/area/external/shuttle/station/escape)
"bo" = (
/obj/machinery/door/firedoor/border_only{
	dir = 1
	},
/turf/open/floor/mineral/titanium,
/area/external/shuttle/station/escape)
"bp" = (
/obj/structure/chair/comfy/shuttle{
	dir = 1
	},
/obj/machinery/light{
	dir = 1
	},
/turf/open/floor/mineral/titanium/blue,
/area/external/shuttle/station/escape)
"bq" = (
/obj/structure/window/reinforced{
	dir = 4
	},
/obj/machinery/door/firedoor/border_only{
	dir = 4
	},
/turf/open/floor/mineral/titanium,
/area/external/shuttle/station/escape)
"br" = (
/obj/structure/window/reinforced{
	dir = 4
	},
/obj/structure/chair/comfy/shuttle{
	dir = 4
	},
/obj/machinery/door/firedoor/border_only{
	dir = 1
	},
/obj/machinery/door/firedoor/border_only{
	dir = 4
	},
/turf/open/floor/mineral/titanium/blue,
/area/external/shuttle/station/escape)
"bs" = (
/obj/structure/window/reinforced{
	dir = 4
	},
/obj/structure/chair/comfy/shuttle{
	dir = 4
	},
/obj/machinery/door/firedoor/border_only{
	dir = 4
	},
/turf/open/floor/mineral/titanium/blue,
/area/external/shuttle/station/escape)
"bt" = (
/obj/structure/window/reinforced{
	dir = 4
	},
/obj/structure/chair/comfy/shuttle{
	dir = 4
	},
/obj/machinery/door/firedoor/border_only,
/obj/machinery/door/firedoor/border_only{
	dir = 4
	},
/turf/open/floor/mineral/titanium/blue,
/area/external/shuttle/station/escape)
"bu" = (
/obj/structure/window/reinforced{
	dir = 4
	},
/obj/machinery/door/firedoor/border_only{
	dir = 4
	},
/turf/open/floor/mineral/titanium/blue,
/area/external/shuttle/station/escape)
"bv" = (
/obj/structure/table,
/obj/machinery/recharger,
/turf/open/floor/mineral/titanium/blue,
/area/external/shuttle/station/escape)
"er" = (
/obj/structure/chair/comfy/shuttle,
/obj/machinery/door/firedoor/border_only,
/turf/open/floor/mineral/titanium/blue,
/area/external/shuttle/station/escape)
"gW" = (
/obj/effect/spawner/structure/window/shuttle,
/obj/machinery/door/firedoor/border_only{
	dir = 8
	},
/turf/open/floor/plating,
/area/external/shuttle/station/escape)
"hd" = (
/obj/machinery/door/firedoor/border_only,
/turf/open/floor/mineral/titanium,
/area/external/shuttle/station/escape)
"kt" = (
/obj/effect/turf_decal/tile/bar,
/obj/effect/turf_decal/tile/bar{
	dir = 1
	},
/obj/machinery/door/firedoor/border_only{
	dir = 8
	},
/turf/open/floor/plasteel,
/area/external/shuttle/station/escape)
"mX" = (
/obj/structure/chair/comfy/shuttle{
	dir = 1
	},
/obj/machinery/door/firedoor/border_only{
	dir = 4
	},
/turf/open/floor/mineral/titanium/blue,
/area/external/shuttle/station/escape)
"nN" = (
/obj/machinery/door/firedoor/border_only{
	dir = 4
	},
/turf/open/floor/mineral/titanium,
/area/external/shuttle/station/escape)
"Cl" = (
/obj/effect/spawner/structure/window/shuttle,
/obj/machinery/door/firedoor/border_only{
	dir = 1
	},
/turf/open/floor/plating,
/area/external/shuttle/station/escape)
"Dg" = (
/obj/structure/chair/comfy/shuttle{
	dir = 1
	},
/obj/machinery/door/firedoor/border_only{
	dir = 8
	},
/obj/machinery/door/firedoor/border_only{
	dir = 1
	},
/turf/open/floor/mineral/titanium/blue,
/area/external/shuttle/station/escape)
"DP" = (
/obj/structure/chair/comfy/shuttle,
/obj/machinery/door/firedoor/border_only{
	dir = 4
	},
/turf/open/floor/mineral/titanium/blue,
/area/external/shuttle/station/escape)
"Gc" = (
/obj/machinery/door/firedoor/border_only{
	dir = 8
	},
/turf/open/floor/mineral/titanium,
/area/external/shuttle/station/escape)
"Jm" = (
/obj/structure/chair/comfy/shuttle{
	dir = 1
	},
/obj/machinery/door/firedoor/border_only{
	dir = 1
	},
/obj/machinery/door/firedoor/border_only{
	dir = 4
	},
/turf/open/floor/mineral/titanium/blue,
/area/external/shuttle/station/escape)
"Nk" = (
/obj/structure/chair/comfy/shuttle{
	dir = 1
	},
/obj/machinery/door/firedoor/border_only{
	dir = 1
	},
/turf/open/floor/mineral/titanium/blue,
/area/external/shuttle/station/escape)
"Ok" = (
/obj/structure/chair/comfy/shuttle{
	dir = 1
	},
/obj/machinery/door/firedoor/border_only{
	dir = 8
	},
/turf/open/floor/mineral/titanium/blue,
/area/external/shuttle/station/escape)
"Ww" = (
/obj/structure/chair/comfy/shuttle,
/obj/machinery/door/firedoor/border_only{
	dir = 8
	},
/obj/machinery/door/firedoor/border_only,
/turf/open/floor/mineral/titanium/blue,
/area/external/shuttle/station/escape)

(1,1,1) = {"
aa
aa
aa
aa
ab
ab
ab
aC
ab
aK
ab
gW
gW
gW
ab
aZ
ab
aZ
ab
ab
ab
aa
"}
(2,1,1) = {"
aa
ab
ab
ab
ac
ac
ax
aD
ab
bp
aA
aG
aw
aR
aX
av
ab
be
bg
bj
ab
ab
"}
(3,1,1) = {"
ab
ad
ai
am
aq
at
ay
aE
ab
aL
ac
aN
aP
aS
aY
ba
ab
be
ab
ab
bl
bn
"}
(4,1,1) = {"
Cl
ae
aj
ak
ac
ac
ay
aE
ab
aL
ac
aO
aQ
aO
aY
av
ab
bf
bh
bj
bl
bn
"}
(5,1,1) = {"
Cl
af
ak
an
ab
ac
az
ac
ad
mX
ac
DP
nN
mX
ac
kt
bc
be
ab
ab
bl
bn
"}
(6,1,1) = {"
Cl
ag
ak
ao
ab
au
aA
aF
aw
bo
hd
aw
aw
aL
ac
av
bd
be
bi
bk
bl
bn
"}
(7,1,1) = {"
Cl
af
ak
aI
ar
av
ac
aG
aw
Dg
ac
Ww
Gc
Ok
ac
bb
ad
ab
ab
ab
bm
bn
"}
(8,1,1) = {"
ah
al
ap
aa
Cl
ac
aB
aH
aw
Nk
ac
er
aw
aT
ab
aa
aa
aa
aa
aa
aa
aa
"}
(9,1,1) = {"
aa
aa
aa
aa
as
aw
hd
aw
aw
Nk
ac
er
aw
aU
ab
aa
aa
aa
aa
aa
aa
aa
"}
(10,1,1) = {"
aa
aa
aa
aa
aJ
aM
aB
aV
aw
Jm
ac
er
aw
bv
ab
aa
aa
aa
aa
aa
aa
aa
"}
(11,1,1) = {"
aa
aa
aa
aa
aa
aa
ab
aW
bq
br
bs
bt
bq
bu
ab
aa
aa
aa
aa
aa
aa
aa
"}
