//MAP CONVERTED BY dmm2tgm.py THIS HEADER COMMENT PREVENTS RECONVERSION, DO NOT REMOVE
"aa" = (
/turf/template_noop,
/area/template_noop)
"ab" = (
/turf/closed/wall/mineral/titanium,
/area/external/shuttle/station/escape)
"ac" = (
/obj/effect/spawner/structure/window/shuttle,
/turf/open/floor/plating,
/area/external/shuttle/station/escape)
"ad" = (
/obj/structure/table,
/obj/machinery/chem_dispenser/drinks/beer{
	dir = 8
	},
/obj/effect/turf_decal/tile/bar,
/obj/effect/turf_decal/tile/bar{
	dir = 1
	},
/turf/open/floor/plasteel,
/area/external/shuttle/station/escape)
"ae" = (
/turf/closed/wall/mineral/titanium/nodiagonal,
/area/external/shuttle/station/escape)
"af" = (
/obj/structure/table/wood,
/obj/item/flashlight/lamp/green,
/turf/open/floor/carpet,
/area/external/shuttle/station/escape)
"ag" = (
/obj/structure/chair/comfy/brown{
	dir = 1
	},
/turf/open/floor/carpet,
/area/external/shuttle/station/escape)
"ah" = (
/obj/machinery/computer/emergency_shuttle,
/turf/open/floor/carpet,
/area/external/shuttle/station/escape)
"ai" = (
/obj/structure/table/wood,
/obj/item/storage/fancy/cigarettes/cigars/havana,
/obj/item/lighter{
	pixel_x = -4;
	pixel_y = 6
	},
/turf/open/floor/carpet,
/area/external/shuttle/station/escape)
"aj" = (
/obj/structure/table,
/obj/machinery/chem_dispenser/drinks{
	dir = 8
	},
/obj/effect/turf_decal/tile/bar,
/obj/effect/turf_decal/tile/bar{
	dir = 1
	},
/turf/open/floor/plasteel,
/area/external/shuttle/station/escape)
"ak" = (
/obj/structure/extinguisher_cabinet{
	pixel_y = 30
	},
/obj/machinery/light/small{
	dir = 1
	},
/turf/open/floor/plasteel/freezer,
/area/external/shuttle/station/escape)
"al" = (
/obj/machinery/computer/atmos_alert{
	dir = 4
	},
/turf/open/floor/carpet,
/area/external/shuttle/station/escape)
"am" = (
/obj/structure/chair/comfy/brown{
	dir = 8
	},
/turf/open/floor/carpet,
/area/external/shuttle/station/escape)
"an" = (
/turf/open/floor/carpet,
/area/external/shuttle/station/escape)
"ao" = (
/obj/structure/chair/comfy/brown{
	dir = 4
	},
/turf/open/floor/carpet,
/area/external/shuttle/station/escape)
"ap" = (
/obj/machinery/computer/security{
	dir = 8
	},
/turf/open/floor/carpet,
/area/external/shuttle/station/escape)
"aq" = (
/obj/machinery/computer/crew{
	dir = 4
	},
/turf/open/floor/carpet,
/area/external/shuttle/station/escape)
"ar" = (
/obj/structure/extinguisher_cabinet{
	pixel_y = -30
	},
/obj/structure/chair/comfy/brown{
	dir = 8
	},
/turf/open/floor/carpet,
/area/external/shuttle/station/escape)
"as" = (
/obj/item/radio/intercom{
	name = "Station Intercom (General)";
	pixel_y = -29
	},
/turf/open/floor/carpet,
/area/external/shuttle/station/escape)
"at" = (
/obj/machinery/button/flasher{
	id = "cockpit_flasher";
	pixel_x = 6;
	pixel_y = -24
	},
/obj/structure/table/wood/poker,
/obj/item/storage/box/drinkingglasses,
/obj/item/reagent_containers/food/drinks/bottle/whiskey,
/obj/machinery/light,
/turf/open/floor/carpet,
/area/external/shuttle/station/escape)
"au" = (
/obj/machinery/computer/communications/unlocked{
	dir = 8
	},
/turf/open/floor/carpet,
/area/external/shuttle/station/escape)
"av" = (
/obj/machinery/light/small{
	dir = 4
	},
/obj/structure/toilet{
	dir = 1
	},
/turf/open/floor/plasteel/freezer,
/area/external/shuttle/station/escape)
"aw" = (
/obj/structure/table/wood/bar,
/obj/item/toy/cards/deck/uno{
	pixel_y = 4
	},
/turf/open/floor/plasteel/grimy,
/area/external/shuttle/station/escape)
"az" = (
/obj/machinery/door/airlock/public/glass{
	name = "Emergency Shuttle Cockpit"
	},
/obj/machinery/door/firedoor/border_only{
	dir = 1
	},
/obj/machinery/door/firedoor/border_only,
/obj/effect/mapping_helpers/airlock/access/all/command/general,
/turf/open/floor/carpet,
/area/external/shuttle/station/escape)
"aA" = (
/obj/machinery/status_display/evac,
/turf/closed/wall/mineral/titanium,
/area/external/shuttle/station/escape)
"aC" = (
/obj/structure/chair/comfy/shuttle,
/turf/open/floor/mineral/plastitanium/red/brig,
/area/external/shuttle/station/escape)
"aD" = (
/obj/machinery/flasher{
	id = "cockpit_flasher";
	pixel_x = 6;
	pixel_y = 24
	},
/obj/item/kirbyplants{
	icon_state = "plant-21";
	pixel_x = -3;
	pixel_y = 3
	},
/obj/machinery/light{
	dir = 1
	},
/obj/effect/turf_decal/tile/bar,
/obj/effect/turf_decal/tile/bar{
	dir = 1
	},
/turf/open/floor/plasteel,
/area/external/shuttle/station/escape)
"aE" = (
/obj/effect/turf_decal/tile/bar,
/obj/effect/turf_decal/tile/bar{
	dir = 1
	},
/turf/open/floor/plasteel,
/area/external/shuttle/station/escape)
"aF" = (
/obj/structure/musician/piano{
	icon_state = "piano"
	},
/obj/machinery/door/firedoor/border_only{
	dir = 8
	},
/turf/open/floor/plasteel/grimy,
/area/external/shuttle/station/escape)
"aG" = (
/obj/structure/chair/stool{
	can_buckle = 1
	},
/turf/open/floor/plasteel/grimy,
/area/external/shuttle/station/escape)
"aH" = (
/obj/machinery/flasher{
	id = "shuttle_flasher";
	pixel_x = -24;
	pixel_y = 6
	},
/obj/machinery/button/flasher{
	id = "shuttle_flasher";
	pixel_x = -24;
	pixel_y = -6
	},
/obj/machinery/light/small{
	brightness = 3;
	dir = 8
	},
/turf/open/floor/mineral/plastitanium/red/brig,
/area/external/shuttle/station/escape)
"aI" = (
/turf/open/floor/mineral/plastitanium/red/brig,
/area/external/shuttle/station/escape)
"aJ" = (
/obj/machinery/door/airlock/public/glass{
	name = "Emergency Shuttle Brig"
	},
/obj/effect/turf_decal/tile/bar,
/obj/effect/turf_decal/tile/bar{
	dir = 1
	},
/obj/machinery/door/firedoor/border_only{
	dir = 4
	},
/obj/machinery/door/firedoor/border_only{
	dir = 8
	},
/obj/effect/mapping_helpers/airlock/access/all/security/basic,
/turf/open/floor/plasteel,
/area/external/shuttle/station/escape)
"aK" = (
/obj/machinery/door/airlock/titanium{
	name = "Emergency Shuttle Airlock"
	},
/obj/machinery/door/firedoor/border_only{
	dir = 4
	},
/obj/machinery/door/firedoor/border_only{
	dir = 8
	},
/obj/effect/mapping_helpers/airlock/access/all/security/basic,
/turf/open/floor/mineral/plastitanium/red/brig,
/area/external/shuttle/station/escape)
"aL" = (
/obj/structure/extinguisher_cabinet{
	pixel_y = -30
	},
/turf/open/floor/mineral/plastitanium/red/brig,
/area/external/shuttle/station/escape)
"aM" = (
/obj/structure/chair/comfy/shuttle{
	dir = 1
	},
/turf/open/floor/mineral/plastitanium/red/brig,
/area/external/shuttle/station/escape)
"aN" = (
/obj/structure/chair/stool/bar{
	can_buckle = 1;
	name = "buckleable bar stool"
	},
/obj/effect/turf_decal/tile/bar,
/obj/effect/turf_decal/tile/bar{
	dir = 1
	},
/turf/open/floor/plasteel,
/area/external/shuttle/station/escape)
"aO" = (
/obj/structure/table/wood/bar{
	boot_dir = 9
	},
/obj/effect/turf_decal/tile/bar,
/obj/effect/turf_decal/tile/bar{
	dir = 1
	},
/obj/machinery/door/firedoor/border_only{
	dir = 8
	},
/obj/machinery/door/firedoor/border_only{
	dir = 1
	},
/turf/open/floor/plasteel,
/area/external/shuttle/station/escape)
"aP" = (
/obj/structure/table/wood/bar,
/obj/effect/turf_decal/tile/bar,
/obj/effect/turf_decal/tile/bar{
	dir = 1
	},
/obj/machinery/door/firedoor/border_only{
	dir = 1
	},
/turf/open/floor/plasteel,
/area/external/shuttle/station/escape)
"aR" = (
/obj/structure/table/wood/bar{
	boot_dir = 8
	},
/obj/effect/turf_decal/tile/bar,
/obj/effect/turf_decal/tile/bar{
	dir = 1
	},
/obj/machinery/door/firedoor/border_only{
	dir = 8
	},
/turf/open/floor/plasteel,
/area/external/shuttle/station/escape)
"aS" = (
/obj/structure/extinguisher_cabinet{
	pixel_x = 27
	},
/obj/structure/table,
/obj/item/storage/box/drinkingglasses,
/obj/item/reagent_containers/food/drinks/bottle/lizardwine,
/obj/effect/turf_decal/tile/bar,
/obj/effect/turf_decal/tile/bar{
	dir = 1
	},
/turf/open/floor/plasteel,
/area/external/shuttle/station/escape)
"aT" = (
/obj/machinery/door/airlock/titanium{
	name = "Emergency Shuttle Airlock"
	},
/obj/docking_port/mobile/emergency{
	name = "The Emergency Escape Bar"
	},
/obj/effect/turf_decal/tile/bar,
/obj/effect/turf_decal/tile/bar{
	dir = 1
	},
/obj/machinery/door/firedoor/border_only{
	dir = 4
	},
/obj/machinery/door/firedoor/border_only{
	dir = 8
	},
/turf/open/floor/plasteel,
/area/external/shuttle/station/escape)
"aU" = (
/obj/effect/turf_decal/tile/bar,
/obj/effect/turf_decal/tile/bar{
	dir = 1
	},
/mob/living/simple_animal/hostile/alien/maid/barmaid,
/turf/open/floor/plasteel,
/area/external/shuttle/station/escape)
"aW" = (
/obj/structure/chair/wood/normal,
/obj/machinery/door/firedoor/border_only{
	dir = 1
	},
/turf/open/floor/plasteel/grimy,
/area/external/shuttle/station/escape)
"aX" = (
/obj/machinery/light{
	dir = 4
	},
/obj/effect/turf_decal/tile/bar,
/obj/effect/turf_decal/tile/bar{
	dir = 1
	},
/mob/living/simple_animal/drone/snowflake/bardrone,
/turf/open/floor/plasteel,
/area/external/shuttle/station/escape)
"aY" = (
/obj/machinery/vending/boozeomat,
/turf/closed/wall/mineral/titanium,
/area/external/shuttle/station/escape)
"aZ" = (
/obj/structure/chair/wood/normal{
	dir = 4
	},
/turf/open/floor/plasteel/grimy,
/area/external/shuttle/station/escape)
"ba" = (
/obj/structure/table/wood/bar,
/obj/effect/spawner/lootdrop/gambling,
/turf/open/floor/plasteel/grimy,
/area/external/shuttle/station/escape)
"bc" = (
/obj/item/kirbyplants{
	icon_state = "plant-21";
	pixel_x = -3;
	pixel_y = 3
	},
/turf/open/floor/plasteel/grimy,
/area/external/shuttle/station/escape)
"bd" = (
/obj/structure/table/wood/bar{
	boot_dir = 10
	},
/obj/effect/turf_decal/tile/bar,
/obj/effect/turf_decal/tile/bar{
	dir = 1
	},
/obj/machinery/door/firedoor/border_only{
	dir = 8
	},
/obj/machinery/door/firedoor/border_only,
/turf/open/floor/plasteel,
/area/external/shuttle/station/escape)
"be" = (
/obj/structure/table/wood/bar{
	boot_dir = 2
	},
/obj/effect/turf_decal/tile/bar,
/obj/effect/turf_decal/tile/bar{
	dir = 1
	},
/obj/machinery/door/firedoor/border_only,
/turf/open/floor/plasteel,
/area/external/shuttle/station/escape)
"bg" = (
/obj/machinery/door/airlock/titanium{
	name = "Emergency Shuttle Airlock"
	},
/obj/effect/turf_decal/tile/bar,
/obj/effect/turf_decal/tile/bar{
	dir = 1
	},
/obj/machinery/door/firedoor/border_only{
	dir = 4
	},
/obj/machinery/door/firedoor/border_only{
	dir = 8
	},
/turf/open/floor/plasteel,
/area/external/shuttle/station/escape)
"bi" = (
/turf/open/floor/mineral/titanium,
/area/external/shuttle/station/escape)
"bk" = (
/obj/machinery/vending/cigarette,
/obj/effect/turf_decal/tile/bar,
/obj/effect/turf_decal/tile/bar{
	dir = 1
	},
/turf/open/floor/plasteel,
/area/external/shuttle/station/escape)
"bm" = (
/obj/machinery/door/airlock{
	name = "Unisex Restrooms"
	},
/obj/machinery/door/firedoor/border_only{
	dir = 1
	},
/obj/machinery/door/firedoor/border_only,
/turf/open/floor/plasteel/freezer,
/area/external/shuttle/station/escape)
"bn" = (
/obj/effect/spawner/structure/window/shuttle,
/obj/structure/sign/departments/medbay/alt,
/turf/closed/wall/mineral/titanium,
/area/external/shuttle/station/escape)
"bo" = (
/obj/machinery/door/airlock/titanium{
	name = "Emergency Shuttle Airlock"
	},
/obj/machinery/door/firedoor/border_only{
	dir = 4
	},
/obj/machinery/door/firedoor/border_only{
	dir = 8
	},
/turf/open/floor/plasteel/freezer,
/area/external/shuttle/station/escape)
"bp" = (
/turf/open/floor/plasteel/freezer,
/area/external/shuttle/station/escape)
"bq" = (
/obj/machinery/door/airlock/medical/glass{
	name = "Medbay"
	},
/obj/machinery/door/firedoor/border_only{
	dir = 1
	},
/obj/machinery/door/firedoor/border_only,
/turf/open/floor/mineral/titanium,
/area/external/shuttle/station/escape)
"bs" = (
/obj/machinery/door/airlock{
	name = "Unit 1"
	},
/obj/machinery/door/firedoor/border_only{
	dir = 1
	},
/obj/machinery/door/firedoor/border_only,
/turf/open/floor/plasteel/freezer,
/area/external/shuttle/station/escape)
"bu" = (
/obj/machinery/door/airlock{
	name = "Unit 2"
	},
/obj/machinery/door/firedoor/border_only{
	dir = 1
	},
/obj/machinery/door/firedoor/border_only,
/turf/open/floor/plasteel/freezer,
/area/external/shuttle/station/escape)
"bv" = (
/obj/machinery/door/airlock{
	name = "Unit B"
	},
/obj/machinery/door/firedoor/border_only{
	dir = 1
	},
/obj/machinery/door/firedoor/border_only,
/turf/open/floor/plasteel/freezer,
/area/external/shuttle/station/escape)
"bw" = (
/obj/structure/table/optable,
/obj/item/surgical_drapes,
/obj/machinery/light/small{
	brightness = 3;
	dir = 8
	},
/turf/open/floor/mineral/titanium,
/area/external/shuttle/station/escape)
"by" = (
/obj/machinery/recharge_station,
/obj/machinery/light/small{
	dir = 4
	},
/turf/open/floor/plasteel/freezer,
/area/external/shuttle/station/escape)
"bz" = (
/obj/structure/table,
/obj/item/circular_saw,
/obj/item/hemostat,
/obj/item/retractor,
/obj/item/scalpel,
/obj/item/surgicaldrill,
/obj/item/cautery,
/turf/open/floor/mineral/titanium,
/area/external/shuttle/station/escape)
"bC" = (
/obj/structure/window/reinforced{
	dir = 1
	},
/obj/structure/shuttle/engine/heater,
/turf/open/floor/plating/airless,
/area/external/shuttle/station/escape)
"bE" = (
/obj/structure/shuttle/engine/propulsion,
/turf/open/floor/plating/airless,
/area/external/shuttle/station/escape)
"bG" = (
/obj/item/kirbyplants{
	icon_state = "plant-21";
	pixel_x = -3;
	pixel_y = 3
	},
/obj/effect/turf_decal/tile/bar,
/obj/effect/turf_decal/tile/bar{
	dir = 1
	},
/turf/open/floor/plasteel,
/area/external/shuttle/station/escape)
"bH" = (
/obj/machinery/door/firedoor/border_only{
	dir = 8
	},
/turf/open/floor/plasteel/grimy,
/area/external/shuttle/station/escape)
"bI" = (
/obj/structure/table/wood/bar,
/obj/item/instrument/guitar,
/obj/effect/turf_decal/tile/bar,
/obj/effect/turf_decal/tile/bar{
	dir = 1
	},
/obj/machinery/door/firedoor/border_only{
	dir = 1
	},
/turf/open/floor/plasteel,
/area/external/shuttle/station/escape)
"bJ" = (
/obj/structure/table/wood/bar,
/obj/item/storage/fancy/donut_box,
/turf/open/floor/plasteel/grimy,
/area/external/shuttle/station/escape)
"bK" = (
/obj/structure/chair/wood/normal{
	dir = 8
	},
/obj/machinery/door/firedoor/border_only{
	dir = 4
	},
/turf/open/floor/plasteel/grimy,
/area/external/shuttle/station/escape)
"bM" = (
/obj/structure/chair/comfy/brown{
	dir = 8
	},
/turf/open/floor/plasteel/grimy,
/area/external/shuttle/station/escape)
"bN" = (
/obj/structure/table,
/obj/item/storage/box/drinkingglasses,
/obj/item/reagent_containers/food/drinks/shaker,
/obj/item/storage/fancy/cigarettes/cigars/havana,
/obj/effect/turf_decal/tile/bar,
/obj/effect/turf_decal/tile/bar{
	dir = 1
	},
/turf/open/floor/plasteel,
/area/external/shuttle/station/escape)
"bO" = (
/obj/structure/table/wood/bar,
/obj/item/folder/red,
/turf/open/floor/plasteel/grimy,
/area/external/shuttle/station/escape)
"bP" = (
/obj/structure/table/wood/bar,
/obj/item/toy/cards/deck/cas,
/obj/item/toy/cards/deck/cas/black{
	pixel_y = 6
	},
/turf/open/floor/plasteel/grimy,
/area/external/shuttle/station/escape)
"bQ" = (
/obj/structure/chair/wood/normal{
	dir = 1
	},
/obj/machinery/door/firedoor/border_only,
/turf/open/floor/plasteel/grimy,
/area/external/shuttle/station/escape)
"bR" = (
/obj/structure/extinguisher_cabinet{
	pixel_y = -30
	},
/obj/effect/turf_decal/tile/bar,
/obj/effect/turf_decal/tile/bar{
	dir = 1
	},
/turf/open/floor/plasteel,
/area/external/shuttle/station/escape)
"bS" = (
/obj/structure/table,
/obj/item/storage/firstaid/regular,
/obj/item/storage/firstaid/toxin{
	pixel_x = 4;
	pixel_y = 4
	},
/turf/open/floor/mineral/titanium,
/area/external/shuttle/station/escape)
"bT" = (
/obj/item/kirbyplants{
	icon_state = "plant-10"
	},
/obj/effect/turf_decal/tile/bar,
/obj/effect/turf_decal/tile/bar{
	dir = 1
	},
/turf/open/floor/plasteel,
/area/external/shuttle/station/escape)
"bU" = (
/obj/structure/table,
/obj/item/storage/firstaid/fire,
/obj/item/storage/firstaid/brute{
	pixel_x = 4;
	pixel_y = 4
	},
/turf/open/floor/mineral/titanium,
/area/external/shuttle/station/escape)
"bV" = (
/obj/structure/table/wood/bar{
	boot_dir = 8
	},
/obj/effect/fun_balloon/sentience/emergency_shuttle{
	group_name = "bar staff on the Emergency Escape Bar"
	},
/obj/effect/turf_decal/tile/bar,
/obj/effect/turf_decal/tile/bar{
	dir = 1
	},
/obj/machinery/door/firedoor/border_only{
	dir = 8
	},
/turf/open/floor/plasteel,
/area/external/shuttle/station/escape)
"bW" = (
/obj/machinery/light/small{
	dir = 4
	},
/turf/open/floor/plasteel/grimy,
/area/external/shuttle/station/escape)
"bX" = (
/obj/machinery/light{
	dir = 8
	},
/obj/effect/turf_decal/tile/bar,
/obj/effect/turf_decal/tile/bar{
	dir = 1
	},
/turf/open/floor/plasteel,
/area/external/shuttle/station/escape)
"bY" = (
/obj/machinery/light/small{
	dir = 1
	},
/obj/effect/turf_decal/tile/bar,
/obj/effect/turf_decal/tile/bar{
	dir = 1
	},
/turf/open/floor/plasteel,
/area/external/shuttle/station/escape)
"bZ" = (
/obj/machinery/light/small,
/obj/effect/turf_decal/tile/bar,
/obj/effect/turf_decal/tile/bar{
	dir = 1
	},
/turf/open/floor/plasteel,
/area/external/shuttle/station/escape)
"ca" = (
/obj/machinery/light,
/obj/effect/turf_decal/tile/bar,
/obj/effect/turf_decal/tile/bar{
	dir = 1
	},
/turf/open/floor/plasteel,
/area/external/shuttle/station/escape)
"hn" = (
/obj/machinery/door/firedoor/border_only{
	dir = 1
	},
/obj/machinery/door/firedoor/border_only{
	dir = 4
	},
/turf/open/floor/plasteel/grimy,
/area/external/shuttle/station/escape)
"ka" = (
/obj/effect/spawner/structure/window/shuttle,
/obj/machinery/door/firedoor/border_only{
	dir = 8
	},
/turf/open/floor/plating,
/area/external/shuttle/station/escape)
"li" = (
/obj/machinery/door/firedoor/border_only,
/obj/machinery/door/firedoor/border_only{
	dir = 4
	},
/turf/open/floor/plasteel/grimy,
/area/external/shuttle/station/escape)
"ne" = (
/obj/structure/chair/stool/bar{
	can_buckle = 1;
	name = "buckleable bar stool"
	},
/obj/effect/turf_decal/tile/bar,
/obj/effect/turf_decal/tile/bar{
	dir = 1
	},
/obj/machinery/door/firedoor/border_only,
/turf/open/floor/plasteel,
/area/external/shuttle/station/escape)
"uE" = (
/obj/effect/turf_decal/tile/bar,
/obj/effect/turf_decal/tile/bar{
	dir = 1
	},
/obj/machinery/door/firedoor/border_only{
	dir = 8
	},
/turf/open/floor/plasteel,
/area/external/shuttle/station/escape)
"vv" = (
/obj/machinery/door/firedoor/border_only{
	dir = 1
	},
/turf/open/floor/plasteel/grimy,
/area/external/shuttle/station/escape)
"vS" = (
/obj/effect/turf_decal/tile/bar,
/obj/effect/turf_decal/tile/bar{
	dir = 1
	},
/obj/machinery/door/firedoor/border_only{
	dir = 1
	},
/turf/open/floor/plasteel,
/area/external/shuttle/station/escape)
"xR" = (
/obj/machinery/door/firedoor/border_only{
	dir = 4
	},
/turf/open/floor/plasteel/grimy,
/area/external/shuttle/station/escape)
"yx" = (
/obj/structure/chair/stool/bar{
	can_buckle = 1;
	name = "buckleable bar stool"
	},
/obj/effect/turf_decal/tile/bar,
/obj/effect/turf_decal/tile/bar{
	dir = 1
	},
/obj/machinery/door/firedoor/border_only{
	dir = 1
	},
/turf/open/floor/plasteel,
/area/external/shuttle/station/escape)
"AU" = (
/obj/structure/chair/stool/bar{
	can_buckle = 1;
	name = "buckleable bar stool"
	},
/obj/effect/turf_decal/tile/bar,
/obj/effect/turf_decal/tile/bar{
	dir = 1
	},
/obj/machinery/door/firedoor/border_only{
	dir = 8
	},
/turf/open/floor/plasteel,
/area/external/shuttle/station/escape)
"AX" = (
/obj/machinery/stasis{
	dir = 8
	},
/turf/open/floor/mineral/titanium,
/area/external/shuttle/station/escape)
"EQ" = (
/obj/effect/spawner/structure/window/shuttle,
/obj/machinery/door/firedoor/border_only{
	dir = 4
	},
/turf/open/floor/plating,
/area/external/shuttle/station/escape)
"HS" = (
/obj/effect/spawner/structure/window/shuttle,
/obj/machinery/door/firedoor/border_only{
	dir = 1
	},
/turf/open/floor/plating,
/area/external/shuttle/station/escape)
"Lx" = (
/obj/effect/turf_decal/tile/bar,
/obj/effect/turf_decal/tile/bar{
	dir = 1
	},
/obj/machinery/door/firedoor/border_only,
/turf/open/floor/plasteel,
/area/external/shuttle/station/escape)
"Nt" = (
/obj/machinery/portable_atmospherics/canister/air,
/turf/open/floor/mineral/titanium,
/area/external/shuttle/station/escape)
"Os" = (
/obj/machinery/light/small{
	dir = 4
	},
/obj/machinery/stasis{
	dir = 8
	},
/turf/open/floor/mineral/titanium,
/area/external/shuttle/station/escape)
"Uc" = (
/obj/machinery/door/firedoor/border_only,
/turf/open/floor/plasteel/grimy,
/area/external/shuttle/station/escape)
"XK" = (
/obj/effect/turf_decal/tile/bar,
/obj/effect/turf_decal/tile/bar{
	dir = 1
	},
/obj/machinery/door/firedoor/border_only{
	dir = 4
	},
/turf/open/floor/plasteel,
/area/external/shuttle/station/escape)
"Yn" = (
/obj/machinery/vending/wallmed{
	name = "Emergency NanoMed";
	use_power = 0
	},
/turf/closed/wall/mineral/titanium/nodiagonal,
/area/external/shuttle/station/escape)

(1,1,1) = {"
aa
aa
aa
aa
ab
ab
ab
aK
ab
aT
ab
ka
ka
ka
ab
bg
ab
bo
ab
ab
ab
aa
"}
(2,1,1) = {"
aa
ab
ab
ab
ab
aC
aH
aL
ab
bY
vv
aZ
bc
aZ
Uc
bZ
ab
bp
bs
av
ab
ab
"}
(3,1,1) = {"
ab
ae
al
aq
ab
aC
aI
aM
ab
aE
aW
ba
aw
bO
bQ
bR
ab
bp
ab
ab
bC
bE
"}
(4,1,1) = {"
HS
af
am
ar
ab
aC
aI
aM
ab
aE
aW
bJ
bM
bP
bQ
aE
ab
ak
bu
av
bC
bE
"}
(5,1,1) = {"
HS
ag
an
as
ab
ac
aJ
ac
ae
XK
hn
bK
xR
bK
li
XK
aA
bp
ab
ab
bC
bE
"}
(6,1,1) = {"
HS
ah
an
at
ab
aD
aE
vS
bX
aE
aE
aE
aE
Lx
aE
aE
bm
bp
bv
by
bC
bE
"}
(7,1,1) = {"
HS
ag
an
an
az
aE
aE
yx
aN
aN
aN
aN
aN
ne
aE
ca
Yn
ab
ab
ab
bC
bE
"}
(8,1,1) = {"
HS
ai
ao
ao
aA
bG
aE
aO
aR
bV
aR
aR
aR
bd
AU
uE
bn
Nt
bw
bz
bC
bE
"}
(9,1,1) = {"
ab
ae
ap
au
ab
aF
bH
aP
aE
aU
aX
aE
aE
be
aE
aE
bq
bi
bi
bS
bC
bE
"}
(10,1,1) = {"
aa
ab
ab
ab
ab
aG
bW
bI
aS
ad
aY
aj
bN
be
bT
bk
ac
AX
Os
bU
ab
ab
"}
(11,1,1) = {"
aa
aa
aa
aa
ab
EQ
ab
EQ
ab
ab
ab
EQ
EQ
EQ
ab
ab
ab
EQ
ab
EQ
ab
aa
"}
