//MAP CONVERTED BY dmm2tgm.py THIS HEADER COMMENT PREVENTS RECONVERSION, DO NOT REMOVE
"aa" = (
/turf/template_noop,
/area/template_noop)
"ab" = (
/obj/machinery/door/airlock/titanium{
	name = "Emergency Shuttle Airlock"
	},
/obj/machinery/door/firedoor/border_only{
	dir = 1
	},
/obj/machinery/door/firedoor/border_only,
/turf/open/floor/mineral/titanium/yellow,
/area/external/shuttle/station/escape)
"ac" = (
/turf/closed/wall/mineral/titanium,
/area/external/shuttle/station/escape)
"ad" = (
/obj/machinery/door/airlock/security/glass{
	name = "Emergency Shuttle Brig"
	},
/obj/machinery/door/firedoor/border_only{
	dir = 4
	},
/obj/machinery/door/firedoor/border_only{
	dir = 8
	},
/obj/effect/mapping_helpers/airlock/access/all/security/general,
/turf/open/floor/mineral/plastitanium/red/brig,
/area/external/shuttle/station/escape)
"ae" = (
/obj/effect/spawner/structure/window/shuttle,
/obj/machinery/door/firedoor/border_only{
	dir = 4
	},
/turf/open/floor/plating,
/area/external/shuttle/station/escape)
"af" = (
/obj/machinery/computer/emergency_shuttle{
	dir = 4
	},
/turf/open/floor/mineral/titanium/blue,
/area/external/shuttle/station/escape)
"ag" = (
/obj/structure/table,
/turf/open/floor/mineral/titanium,
/area/external/shuttle/station/escape)
"ah" = (
/obj/effect/spawner/structure/window/shuttle,
/turf/open/floor/plating,
/area/external/shuttle/station/escape)
"ai" = (
/obj/machinery/door/airlock/titanium{
	name = "Emergency Shuttle Airlock"
	},
/obj/machinery/door/firedoor/border_only{
	dir = 1
	},
/obj/machinery/door/firedoor/border_only,
/turf/open/floor/mineral/titanium,
/area/external/shuttle/station/escape)
"aj" = (
/obj/machinery/door/airlock/titanium{
	name = "Emergency Shuttle Airlock"
	},
/obj/docking_port/mobile/emergency{
	dir = 2;
	dwidth = 10;
	height = 13;
	name = "Asteroid emergency shuttle";
	width = 28
	},
/obj/machinery/door/firedoor/border_only{
	dir = 1
	},
/obj/machinery/door/firedoor/border_only,
/turf/open/floor/mineral/titanium,
/area/external/shuttle/station/escape)
"ak" = (
/obj/machinery/door/airlock/medical/glass{
	name = "Escape Shuttle Infirmary"
	},
/obj/machinery/door/firedoor/border_only{
	dir = 4
	},
/obj/machinery/door/firedoor/border_only{
	dir = 8
	},
/obj/effect/mapping_helpers/airlock/access/all/medical/general,
/turf/open/floor/mineral/titanium/white,
/area/external/shuttle/station/escape)
"al" = (
/obj/machinery/door/airlock/titanium{
	name = "Emergency Shuttle Airlock"
	},
/obj/machinery/door/firedoor/border_only{
	dir = 1
	},
/obj/machinery/door/firedoor/border_only,
/obj/effect/mapping_helpers/airlock/access/all/security/basic,
/turf/open/floor/mineral/plastitanium/red/brig,
/area/external/shuttle/station/escape)
"am" = (
/obj/structure/shuttle/engine/propulsion{
	dir = 8
	},
/turf/open/floor/plating/airless,
/area/external/shuttle/station/escape)
"an" = (
/obj/structure/shuttle/engine/heater{
	dir = 8
	},
/turf/open/floor/plating/airless,
/area/external/shuttle/station/escape)
"ao" = (
/obj/machinery/door/airlock/medical/glass{
	name = "Escape Shuttle Infirmary"
	},
/obj/machinery/door/firedoor/border_only{
	dir = 4
	},
/obj/machinery/door/firedoor/border_only{
	dir = 8
	},
/turf/open/floor/mineral/titanium/white,
/area/external/shuttle/station/escape)
"ap" = (
/obj/structure/ore_box,
/turf/open/floor/mineral/titanium/yellow,
/area/external/shuttle/station/escape)
"aq" = (
/turf/open/floor/mineral/titanium/yellow,
/area/external/shuttle/station/escape)
"ar" = (
/obj/machinery/recharge_station,
/turf/open/floor/mineral/titanium/yellow,
/area/external/shuttle/station/escape)
"at" = (
/turf/open/floor/mineral/titanium,
/area/external/shuttle/station/escape)
"au" = (
/obj/effect/spawner/structure/window/shuttle,
/obj/machinery/door/firedoor/border_only,
/turf/open/floor/plating,
/area/external/shuttle/station/escape)
"av" = (
/obj/structure/chair/comfy/shuttle{
	dir = 4
	},
/turf/open/floor/mineral/plastitanium/red/brig,
/area/external/shuttle/station/escape)
"aw" = (
/turf/open/floor/mineral/plastitanium/red/brig,
/area/external/shuttle/station/escape)
"ax" = (
/obj/structure/chair/comfy/shuttle{
	dir = 8
	},
/turf/open/floor/mineral/plastitanium/red/brig,
/area/external/shuttle/station/escape)
"ay" = (
/obj/structure/toilet{
	dir = 1
	},
/obj/machinery/light/small{
	dir = 8
	},
/turf/open/floor/mineral/titanium/white,
/area/external/shuttle/station/escape)
"az" = (
/turf/closed/wall/mineral/titanium/nodiagonal,
/area/external/shuttle/station/escape)
"aA" = (
/obj/structure/table,
/obj/item/extinguisher,
/obj/machinery/door/firedoor/border_only{
	dir = 4
	},
/obj/item/extinguisher,
/obj/item/crowbar,
/obj/item/crowbar,
/turf/open/floor/mineral/titanium/blue,
/area/external/shuttle/station/escape)
"aB" = (
/turf/closed/wall/mineral/titanium/interior,
/area/external/shuttle/station/escape)
"aC" = (
/obj/structure/table,
/obj/machinery/recharger,
/turf/open/floor/mineral/titanium/blue,
/area/external/shuttle/station/escape)
"aD" = (
/obj/effect/spawner/structure/window/shuttle,
/obj/machinery/door/firedoor/border_only{
	dir = 1
	},
/obj/machinery/door/firedoor/border_only{
	dir = 8
	},
/turf/open/floor/plating,
/area/external/shuttle/station/escape)
"aE" = (
/obj/structure/chair/comfy/shuttle{
	dir = 4
	},
/obj/item/radio/intercom{
	dir = 8;
	name = "Station Intercom (General)";
	pixel_x = -28
	},
/turf/open/floor/mineral/plastitanium/red/brig,
/area/external/shuttle/station/escape)
"aF" = (
/obj/machinery/suit_storage_unit,
/turf/open/floor/mineral/titanium/yellow,
/area/external/shuttle/station/escape)
"aG" = (
/obj/machinery/door/airlock/mining{
	name = "Emergency Shuttle Storage"
	},
/obj/machinery/door/firedoor/border_only{
	dir = 4
	},
/obj/machinery/door/firedoor/border_only{
	dir = 8
	},
/turf/open/floor/mineral/titanium/yellow,
/area/external/shuttle/station/escape)
"aH" = (
/obj/structure/extinguisher_cabinet{
	pixel_y = 30
	},
/turf/open/floor/mineral/titanium,
/area/external/shuttle/station/escape)
"aI" = (
/obj/structure/closet,
/turf/open/floor/mineral/titanium/blue,
/area/external/shuttle/station/escape)
"aJ" = (
/obj/effect/spawner/structure/window/shuttle,
/obj/machinery/door/firedoor/border_only{
	dir = 1
	},
/obj/machinery/door/firedoor/border_only{
	dir = 4
	},
/turf/open/floor/plating,
/area/external/shuttle/station/escape)
"aK" = (
/obj/structure/chair/comfy/shuttle,
/obj/machinery/door/firedoor/border_only,
/turf/open/floor/mineral/titanium/blue,
/area/external/shuttle/station/escape)
"aL" = (
/obj/structure/table,
/obj/item/storage/firstaid/fire,
/obj/item/storage/firstaid/regular{
	pixel_x = 2;
	pixel_y = 3
	},
/turf/open/floor/mineral/titanium/blue,
/area/external/shuttle/station/escape)
"aM" = (
/obj/structure/closet/emcloset,
/obj/item/radio/intercom{
	broadcasting = 0;
	name = "Station Intercom (General)";
	pixel_y = 23
	},
/turf/open/floor/mineral/titanium/blue,
/area/external/shuttle/station/escape)
"aN" = (
/obj/structure/bed/roller,
/turf/open/floor/mineral/titanium/blue,
/area/external/shuttle/station/escape)
"aO" = (
/obj/effect/spawner/structure/window/shuttle,
/obj/machinery/door/firedoor/border_only{
	dir = 8
	},
/turf/open/floor/plating,
/area/external/shuttle/station/escape)
"aQ" = (
/obj/structure/bed,
/turf/open/floor/mineral/plastitanium/red/brig,
/area/external/shuttle/station/escape)
"aR" = (
/obj/machinery/computer/station_alert{
	dir = 4
	},
/turf/open/floor/mineral/titanium/blue,
/area/external/shuttle/station/escape)
"aT" = (
/obj/structure/chair/office/light{
	name = "Chief Engineer"
	},
/turf/open/floor/mineral/titanium/blue,
/area/external/shuttle/station/escape)
"aU" = (
/obj/structure/chair/office/light{
	name = "Captain"
	},
/obj/machinery/light{
	dir = 1
	},
/turf/open/floor/mineral/titanium/blue,
/area/external/shuttle/station/escape)
"aV" = (
/obj/structure/chair/office/light{
	name = "Head of Security"
	},
/turf/open/floor/mineral/titanium/blue,
/area/external/shuttle/station/escape)
"aW" = (
/obj/item/radio/intercom{
	broadcasting = 0;
	name = "Station Intercom (General)";
	pixel_y = 23
	},
/turf/open/floor/mineral/titanium,
/area/external/shuttle/station/escape)
"aX" = (
/obj/machinery/status_display/ai,
/turf/closed/wall/mineral/titanium,
/area/external/shuttle/station/escape)
"aY" = (
/obj/structure/chair/comfy/shuttle{
	dir = 8
	},
/obj/machinery/door/firedoor/border_only{
	dir = 8
	},
/obj/machinery/door/firedoor/border_only{
	dir = 1
	},
/turf/open/floor/mineral/titanium/blue,
/area/external/shuttle/station/escape)
"aZ" = (
/obj/structure/chair/comfy/shuttle{
	dir = 1
	},
/obj/machinery/door/firedoor/border_only{
	dir = 1
	},
/turf/open/floor/mineral/titanium/blue,
/area/external/shuttle/station/escape)
"ba" = (
/obj/structure/chair/comfy/shuttle{
	dir = 4
	},
/obj/machinery/door/firedoor/border_only{
	dir = 4
	},
/obj/machinery/door/firedoor/border_only{
	dir = 1
	},
/turf/open/floor/mineral/titanium/blue,
/area/external/shuttle/station/escape)
"bb" = (
/obj/machinery/computer/security{
	dir = 4
	},
/turf/open/floor/mineral/plastitanium/red/brig,
/area/external/shuttle/station/escape)
"bc" = (
/obj/structure/table,
/obj/item/paper_bin{
	pixel_x = -1;
	pixel_y = 6
	},
/turf/open/floor/mineral/titanium,
/area/external/shuttle/station/escape)
"be" = (
/obj/structure/table,
/obj/item/folder/blue,
/obj/item/pen,
/obj/machinery/recharger,
/turf/open/floor/mineral/titanium,
/area/external/shuttle/station/escape)
"bf" = (
/obj/machinery/ai_slipper,
/turf/open/floor/mineral/titanium,
/area/external/shuttle/station/escape)
"bg" = (
/obj/machinery/door/airlock/command/glass{
	name = "Emergency Shuttle Cockpit"
	},
/obj/machinery/door/firedoor/border_only{
	dir = 4
	},
/obj/machinery/door/firedoor/border_only{
	dir = 8
	},
/obj/effect/mapping_helpers/airlock/access/all/command/general,
/turf/open/floor/mineral/titanium,
/area/external/shuttle/station/escape)
"bi" = (
/obj/machinery/status_display/evac,
/turf/closed/wall/mineral/titanium,
/area/external/shuttle/station/escape)
"bj" = (
/obj/machinery/computer/communications/unlocked{
	dir = 4
	},
/turf/open/floor/mineral/titanium/blue,
/area/external/shuttle/station/escape)
"bk" = (
/obj/structure/chair/office/light{
	dir = 1;
	name = "Research Director"
	},
/turf/open/floor/mineral/titanium/blue,
/area/external/shuttle/station/escape)
"bl" = (
/obj/structure/chair/office/light{
	dir = 1;
	name = "Head of Personnel"
	},
/turf/open/floor/mineral/titanium/blue,
/area/external/shuttle/station/escape)
"bm" = (
/obj/structure/chair/office/light{
	dir = 1;
	name = "Chief Medical Officer"
	},
/turf/open/floor/mineral/titanium/blue,
/area/external/shuttle/station/escape)
"bn" = (
/obj/structure/extinguisher_cabinet{
	pixel_y = -30
	},
/turf/open/floor/mineral/titanium,
/area/external/shuttle/station/escape)
"bp" = (
/obj/machinery/computer/crew{
	dir = 4
	},
/turf/open/floor/mineral/titanium/white,
/area/external/shuttle/station/escape)
"bs" = (
/obj/structure/bed,
/turf/open/floor/mineral/titanium/white,
/area/external/shuttle/station/escape)
"bt" = (
/obj/structure/sink{
	dir = 8;
	pixel_x = -12;
	pixel_y = 2
	},
/obj/structure/mirror{
	pixel_x = -30
	},
/turf/open/floor/mineral/titanium/white,
/area/external/shuttle/station/escape)
"bu" = (
/obj/machinery/door/airlock{
	name = "Emergency Shuttle Restroom"
	},
/obj/machinery/door/firedoor/border_only{
	dir = 4
	},
/obj/machinery/door/firedoor/border_only{
	dir = 8
	},
/turf/open/floor/mineral/titanium/white,
/area/external/shuttle/station/escape)
"bv" = (
/obj/structure/closet/emcloset,
/turf/open/floor/mineral/titanium/blue,
/area/external/shuttle/station/escape)
"bw" = (
/obj/structure/chair/comfy/shuttle{
	dir = 1
	},
/obj/item/radio/intercom{
	name = "Station Intercom (General)";
	pixel_y = -29
	},
/obj/machinery/door/firedoor/border_only{
	dir = 1
	},
/turf/open/floor/mineral/titanium/blue,
/area/external/shuttle/station/escape)
"bx" = (
/obj/structure/chair/comfy/shuttle{
	dir = 1
	},
/obj/structure/extinguisher_cabinet{
	pixel_y = -30
	},
/obj/machinery/door/firedoor/border_only{
	dir = 1
	},
/turf/open/floor/mineral/titanium/blue,
/area/external/shuttle/station/escape)
"bC" = (
/obj/item/radio/intercom{
	dir = 8;
	name = "Station Intercom (General)";
	pixel_x = -28
	},
/turf/open/floor/mineral/titanium/white,
/area/external/shuttle/station/escape)
"bD" = (
/obj/structure/closet/secure_closet/medical2,
/turf/open/floor/mineral/titanium/white,
/area/external/shuttle/station/escape)
"bE" = (
/obj/structure/toilet{
	dir = 1
	},
/obj/machinery/light/small{
	dir = 4
	},
/turf/open/floor/mineral/titanium/white,
/area/external/shuttle/station/escape)
"bF" = (
/obj/structure/table,
/obj/item/retractor,
/obj/item/hemostat,
/obj/item/scalpel,
/obj/item/surgicaldrill,
/turf/open/floor/mineral/titanium/white,
/area/external/shuttle/station/escape)
"bG" = (
/obj/structure/table/optable,
/turf/open/floor/mineral/titanium/white,
/area/external/shuttle/station/escape)
"bH" = (
/obj/structure/table,
/obj/item/circular_saw,
/obj/item/cautery{
	pixel_x = 4
	},
/obj/item/surgical_drapes,
/turf/open/floor/mineral/titanium/white,
/area/external/shuttle/station/escape)
"bJ" = (
/obj/machinery/light,
/turf/open/floor/mineral/titanium/yellow,
/area/external/shuttle/station/escape)
"bK" = (
/obj/structure/chair/comfy/shuttle,
/obj/machinery/light{
	dir = 1
	},
/obj/machinery/door/firedoor/border_only,
/turf/open/floor/mineral/titanium/blue,
/area/external/shuttle/station/escape)
"bM" = (
/obj/machinery/light,
/turf/open/floor/mineral/plastitanium/red/brig,
/area/external/shuttle/station/escape)
"bN" = (
/obj/machinery/light{
	dir = 1
	},
/turf/open/floor/mineral/titanium/white,
/area/external/shuttle/station/escape)
"bP" = (
/obj/machinery/light,
/obj/machinery/door/firedoor/border_only{
	dir = 4
	},
/turf/open/floor/mineral/titanium/blue,
/area/external/shuttle/station/escape)
"cO" = (
/obj/machinery/door/firedoor/border_only{
	dir = 1
	},
/turf/open/floor/mineral/titanium,
/area/external/shuttle/station/escape)
"fo" = (
/obj/machinery/door/airlock/security/glass{
	name = "Emergency Shuttle Brig"
	},
/obj/machinery/door/firedoor/border_only{
	dir = 4
	},
/obj/machinery/door/firedoor/border_only{
	dir = 8
	},
/obj/effect/mapping_helpers/airlock/access/all/security/basic,
/turf/open/floor/mineral/plastitanium/red/brig,
/area/external/shuttle/station/escape)
"lb" = (
/obj/machinery/light,
/obj/machinery/door/firedoor/border_only{
	dir = 8
	},
/turf/open/floor/mineral/titanium/blue,
/area/external/shuttle/station/escape)
"lp" = (
/obj/structure/chair/comfy/shuttle{
	dir = 8
	},
/obj/machinery/door/firedoor/border_only{
	dir = 8
	},
/turf/open/floor/mineral/titanium/blue,
/area/external/shuttle/station/escape)
"mB" = (
/obj/machinery/door/firedoor/border_only{
	dir = 8
	},
/turf/open/floor/mineral/titanium,
/area/external/shuttle/station/escape)
"nG" = (
/obj/machinery/door/firedoor/border_only{
	dir = 4
	},
/turf/open/floor/mineral/titanium,
/area/external/shuttle/station/escape)
"oF" = (
/obj/effect/spawner/structure/window/shuttle,
/obj/machinery/door/firedoor/border_only{
	dir = 1
	},
/turf/open/floor/plating,
/area/external/shuttle/station/escape)
"sR" = (
/obj/machinery/door/firedoor/border_only,
/turf/open/floor/mineral/titanium,
/area/external/shuttle/station/escape)
"Cu" = (
/obj/structure/chair/comfy/shuttle{
	dir = 4
	},
/obj/machinery/door/firedoor/border_only{
	dir = 4
	},
/obj/machinery/door/firedoor/border_only,
/turf/open/floor/mineral/titanium/blue,
/area/external/shuttle/station/escape)
"Fm" = (
/obj/machinery/door/airlock{
	name = "Emergency Shuttle Restroom"
	},
/obj/machinery/door/firedoor/border_only{
	dir = 1
	},
/obj/machinery/door/firedoor/border_only,
/turf/open/floor/mineral/titanium/white,
/area/external/shuttle/station/escape)
"HD" = (
/obj/structure/chair/comfy/shuttle{
	dir = 4
	},
/obj/machinery/door/firedoor/border_only{
	dir = 4
	},
/turf/open/floor/mineral/titanium/blue,
/area/external/shuttle/station/escape)
"Jx" = (
/turf/open/floor/mineral/titanium/white,
/area/external/shuttle/station/escape)
"JH" = (
/obj/machinery/portable_atmospherics/canister/air,
/turf/open/floor/mineral/titanium/yellow,
/area/external/shuttle/station/escape)
"NO" = (
/obj/structure/chair/comfy/shuttle{
	dir = 8
	},
/obj/machinery/door/firedoor/border_only{
	dir = 8
	},
/obj/machinery/door/firedoor/border_only,
/turf/open/floor/mineral/titanium/blue,
/area/external/shuttle/station/escape)
"RJ" = (
/obj/machinery/vending/wallmed{
	name = "Emergency NanoMed";
	pixel_x = 32;
	use_power = 0
	},
/obj/machinery/stasis{
	dir = 8
	},
/turf/open/floor/mineral/titanium/white,
/area/external/shuttle/station/escape)
"UA" = (
/obj/structure/table,
/obj/item/storage/firstaid/fire,
/obj/item/storage/firstaid/regular{
	pixel_x = 2;
	pixel_y = 3
	},
/obj/machinery/door/firedoor/border_only{
	dir = 8
	},
/turf/open/floor/mineral/titanium/blue,
/area/external/shuttle/station/escape)

(1,1,1) = {"
aa
aa
ac
am
ac
ah
ah
ah
ac
am
ac
aa
aa
"}
(2,1,1) = {"
ac
am
ac
an
ac
aR
af
bj
ac
an
ac
am
ac
"}
(3,1,1) = {"
ac
an
ac
ac
ac
at
at
at
ac
ac
ac
an
ac
"}
(4,1,1) = {"
ac
ac
az
aF
ac
aT
bc
bk
ac
bt
az
ac
ac
"}
(5,1,1) = {"
oF
ap
JH
bJ
ac
aU
ag
bl
ac
bN
Fm
ay
au
"}
(6,1,1) = {"
ab
aq
aq
aq
ac
aV
be
bm
ac
Jx
ac
ac
ac
"}
(7,1,1) = {"
oF
ar
JH
aq
ac
aW
bf
bn
ac
Jx
Fm
bE
au
"}
(8,1,1) = {"
ac
ac
ac
aG
ac
aX
bg
bi
az
bu
az
ac
ac
"}
(9,1,1) = {"
aa
ac
ac
aH
at
at
at
at
at
at
ac
ac
aa
"}
(10,1,1) = {"
aa
aa
ac
aI
at
aY
lp
NO
at
bv
ac
aa
aa
"}
(11,1,1) = {"
aD
aO
aB
aA
nG
aZ
ah
aK
at
aL
ac
aa
aa
"}
(12,1,1) = {"
ai
at
at
sR
at
aZ
ah
aK
nG
bP
ac
aa
aa
"}
(13,1,1) = {"
aJ
ae
aB
bK
at
aZ
ah
aK
at
bw
ac
aa
aa
"}
(14,1,1) = {"
aa
aa
oF
aK
at
aZ
ah
aK
at
aZ
au
aa
aa
"}
(15,1,1) = {"
aa
aa
oF
aK
at
cO
at
sR
at
aZ
au
aa
aa
"}
(16,1,1) = {"
aa
aa
oF
aK
at
aZ
ah
aK
at
aZ
au
aa
aa
"}
(17,1,1) = {"
aD
aO
aB
bK
at
aZ
ah
aK
at
bx
ac
aa
aa
"}
(18,1,1) = {"
aj
at
at
sR
at
aZ
ah
aK
mB
lb
ac
aa
aa
"}
(19,1,1) = {"
aJ
ae
aB
UA
mB
aZ
ah
aK
at
aC
ac
aa
aa
"}
(20,1,1) = {"
aa
aa
ac
aM
at
ba
HD
Cu
at
aI
ac
aa
aa
"}
(21,1,1) = {"
aa
ac
ac
aN
at
at
at
at
at
aN
ac
ac
aa
"}
(22,1,1) = {"
ac
ac
ac
ah
fo
ah
bi
ah
ao
ah
ac
ac
ac
"}
(23,1,1) = {"
ac
av
aE
av
aw
bb
ac
bp
Jx
Jx
bC
bF
ac
"}
(24,1,1) = {"
al
aw
aw
aw
aw
aw
ah
Jx
Jx
Jx
Jx
bG
au
"}
(25,1,1) = {"
ac
ax
ax
ax
aw
bM
ac
bN
Jx
RJ
bD
bH
ac
"}
(26,1,1) = {"
ac
ac
ac
ac
ah
ad
ac
ak
ah
ac
ac
ac
ac
"}
(27,1,1) = {"
aa
aa
ac
ac
aQ
aw
ah
Jx
bs
ac
ac
aa
aa
"}
(28,1,1) = {"
aa
aa
aa
ac
ac
ae
ac
ae
ac
ac
aa
aa
aa
"}
