//MAP CONVERTED BY dmm2tgm.py THIS HEADER COMMENT PREVENTS RECONVERSION, DO NOT REMOVE
"aa" = (
/turf/template_noop,
/area/template_noop)
"ab" = (
/obj/structure/shuttle/engine/propulsion/left{
	dir = 4
	},
/turf/open/floor/plating/airless,
/area/external/shuttle/station/centcom_ferry)
"ac" = (
/obj/structure/shuttle/engine/heater{
	dir = 8
	},
/turf/open/floor/plating/airless,
/area/external/shuttle/station/centcom_ferry)
"ad" = (
/turf/closed/wall/mineral/titanium,
/area/external/shuttle/station/centcom_ferry)
"ae" = (
/obj/machinery/conveyor{
	dir = 1;
	id = "garbage"
	},
/turf/open/floor/wood,
/area/external/shuttle/station/centcom_ferry)
"af" = (
/turf/closed/wall/r_wall,
/area/external/shuttle/station/centcom_ferry)
"ag" = (
/turf/open/floor/plating/airless,
/area/external/shuttle/station/centcom_ferry)
"ah" = (
/obj/machinery/door/airlock/wood,
/obj/machinery/door/firedoor/border_only{
	dir = 4
	},
/obj/machinery/door/firedoor/border_only{
	dir = 8
	},
/turf/open/floor/wood,
/area/external/shuttle/station/centcom_ferry)
"ai" = (
/obj/machinery/vending/liberationstation,
/turf/open/floor/mineral/titanium/blue,
/area/external/shuttle/station/centcom_ferry)
"aj" = (
/obj/machinery/door/airlock/vault,
/obj/machinery/door/firedoor/border_only{
	dir = 4
	},
/obj/machinery/door/firedoor/border_only{
	dir = 8
	},
/turf/open/floor/plating/airless,
/area/external/shuttle/station/centcom_ferry)
"ak" = (
/turf/open/floor/mineral/titanium/blue,
/area/external/shuttle/station/centcom_ferry)
"al" = (
/obj/machinery/computer/shuttle/ferry/request{
	dir = 8
	},
/turf/open/floor/mineral/titanium/blue,
/area/external/shuttle/station/centcom_ferry)
"am" = (
/obj/structure/grille/broken,
/turf/open/floor/plating/airless,
/area/external/shuttle/station/centcom_ferry)
"an" = (
/obj/structure/window/reinforced{
	dir = 8
	},
/obj/machinery/vending/autodrobe,
/turf/open/floor/mineral/titanium/blue,
/area/external/shuttle/station/centcom_ferry)
"ao" = (
/obj/structure/mirror/magic/badmin{
	pixel_x = 30
	},
/turf/open/floor/mineral/titanium/blue,
/area/external/shuttle/station/centcom_ferry)
"ap" = (
/turf/closed/wall,
/area/external/shuttle/station/centcom_ferry)
"aq" = (
/obj/structure/window/reinforced{
	dir = 8
	},
/obj/machinery/vending/clothing,
/turf/open/floor/mineral/titanium/blue,
/area/external/shuttle/station/centcom_ferry)
"ar" = (
/obj/structure/chair/comfy/shuttle,
/turf/open/floor/wood,
/area/external/shuttle/station/centcom_ferry)
"as" = (
/obj/structure/emergency_shield,
/turf/open/floor/mineral/titanium/blue/airless,
/area/external/shuttle/station/centcom_ferry)
"at" = (
/obj/machinery/door/airlock,
/obj/machinery/door/firedoor/border_only{
	dir = 4
	},
/obj/machinery/door/firedoor/border_only{
	dir = 8
	},
/turf/open/floor/mineral/titanium/blue,
/area/external/shuttle/station/centcom_ferry)
"au" = (
/turf/open/floor/wood,
/area/external/shuttle/station/centcom_ferry)
"av" = (
/obj/effect/spawner/structure/window/shuttle,
/obj/machinery/door/firedoor/border_only{
	dir = 1
	},
/turf/open/floor/plating,
/area/external/shuttle/station/centcom_ferry)
"aw" = (
/obj/effect/spawner/structure/window/shuttle,
/turf/closed/wall/mineral/titanium,
/area/external/shuttle/station/centcom_ferry)
"ax" = (
/obj/structure/table/wood,
/obj/structure/window/reinforced{
	dir = 4
	},
/obj/machinery/door/firedoor/border_only{
	dir = 4
	},
/turf/open/floor/wood,
/area/external/shuttle/station/centcom_ferry)
"ay" = (
/obj/machinery/door/firedoor/border_only{
	dir = 4
	},
/turf/open/floor/bluespace,
/area/external/shuttle/station/centcom_ferry)
"az" = (
/obj/structure/table/wood,
/obj/item/toy/crayon/spraycan,
/obj/machinery/door/firedoor/border_only{
	dir = 4
	},
/turf/open/floor/wood,
/area/external/shuttle/station/centcom_ferry)
"aA" = (
/obj/effect/spawner/structure/window/shuttle,
/obj/machinery/door/firedoor/border_only,
/turf/open/floor/plating,
/area/external/shuttle/station/centcom_ferry)
"aB" = (
/obj/structure/grille/broken,
/obj/structure/window/fulltile,
/turf/open/floor/mineral/titanium/blue,
/area/external/shuttle/station/centcom_ferry)
"aC" = (
/obj/structure/table/wood,
/obj/structure/window/reinforced{
	dir = 4
	},
/obj/item/vending_refill/snack,
/obj/machinery/door/firedoor/border_only{
	dir = 4
	},
/turf/open/floor/wood,
/area/external/shuttle/station/centcom_ferry)
"aD" = (
/turf/open/floor/carpet,
/area/external/shuttle/station/centcom_ferry)
"aE" = (
/turf/open/floor/bluespace,
/area/external/shuttle/station/centcom_ferry)
"aF" = (
/obj/machinery/vending/sovietsoda,
/turf/open/floor/mineral/titanium/blue,
/area/external/shuttle/station/centcom_ferry)
"aG" = (
/obj/machinery/vending/snack,
/turf/open/floor/mineral/titanium/blue,
/area/external/shuttle/station/centcom_ferry)
"aH" = (
/obj/machinery/newscaster{
	pixel_y = 30
	},
/turf/open/floor/mineral/titanium/blue,
/area/external/shuttle/station/centcom_ferry)
"aI" = (
/obj/structure/bed,
/obj/item/bedsheet/wiz,
/turf/open/floor/mineral/titanium/blue,
/area/external/shuttle/station/centcom_ferry)
"aJ" = (
/obj/structure/chair/comfy/shuttle,
/turf/open/floor/mineral/titanium/blue,
/area/external/shuttle/station/centcom_ferry)
"aK" = (
/obj/structure/table/wood,
/obj/item/flashlight/lamp/green,
/turf/open/floor/mineral/titanium/blue,
/area/external/shuttle/station/centcom_ferry)
"aL" = (
/turf/closed/wall/rust,
/area/external/shuttle/station/centcom_ferry)
"aM" = (
/turf/closed/wall/mineral/titanium/nodiagonal,
/area/external/shuttle/station/centcom_ferry)
"aN" = (
/obj/machinery/power/grounding_rod{
	anchored = 1
	},
/turf/open/floor/mineral/titanium/blue,
/area/external/shuttle/station/centcom_ferry)
"aO" = (
/obj/machinery/door/airlock/titanium,
/obj/docking_port/mobile{
	dir = 8;
	dwidth = 8;
	height = 27;
	shuttle_id = "ferry";
	name = "The Lighthouse";
	port_direction = 2;
	width = 16
	},
/obj/machinery/door/firedoor/border_only{
	dir = 4
	},
/obj/machinery/door/firedoor/border_only{
	dir = 8
	},
/turf/open/floor/mineral/titanium/blue,
/area/external/shuttle/station/centcom_ferry)
"aP" = (
/obj/machinery/vending/magivend,
/turf/open/floor/mineral/titanium/blue,
/area/external/shuttle/station/centcom_ferry)
"aQ" = (
/obj/effect/spawner/structure/window,
/turf/open/floor/mineral/titanium/blue,
/area/external/shuttle/station/centcom_ferry)
"aR" = (
/obj/structure/chair/office/dark{
	dir = 4
	},
/turf/open/floor/wood,
/area/external/shuttle/station/centcom_ferry)
"aT" = (
/obj/structure/bed,
/obj/item/bedsheet/centcom,
/turf/open/floor/mineral/titanium/blue,
/area/external/shuttle/station/centcom_ferry)
"aU" = (
/obj/structure/bed,
/obj/item/bedsheet/rainbow,
/turf/open/floor/mineral/titanium/blue,
/area/external/shuttle/station/centcom_ferry)
"aV" = (
/obj/structure/closet/crate,
/turf/open/floor/mineral/titanium/blue,
/area/external/shuttle/station/centcom_ferry)
"aW" = (
/obj/structure/chair/comfy/shuttle{
	dir = 1
	},
/turf/open/floor/mineral/titanium/blue,
/area/external/shuttle/station/centcom_ferry)
"aX" = (
/obj/structure/window/fulltile,
/turf/open/floor/mineral/titanium/blue,
/area/external/shuttle/station/centcom_ferry)
"aY" = (
/obj/effect/spawner/structure/window/reinforced,
/turf/closed/wall/mineral/titanium,
/area/external/shuttle/station/centcom_ferry)
"bb" = (
/obj/machinery/conveyor{
	dir = 1;
	id = "garbage";
	layer = 2.5
	},
/turf/open/floor/wood,
/area/external/shuttle/station/centcom_ferry)
"bd" = (
/obj/item/kirbyplants/dead{
	desc = "It doesn't look very healthy...";
	name = "potted plant"
	},
/turf/open/floor/wood,
/area/external/shuttle/station/centcom_ferry)
"be" = (
/obj/machinery/conveyor{
	dir = 4;
	id = "garbage"
	},
/turf/open/floor/wood,
/area/external/shuttle/station/centcom_ferry)
"bf" = (
/obj/machinery/conveyor{
	dir = 4;
	id = "garbage"
	},
/obj/structure/plasticflaps,
/turf/open/floor/wood,
/area/external/shuttle/station/centcom_ferry)
"bg" = (
/obj/machinery/conveyor/inverted{
	dir = 10;
	id = "garbage"
	},
/turf/open/floor/wood,
/area/external/shuttle/station/centcom_ferry)
"bh" = (
/obj/structure/foamedmetal,
/turf/open/floor/plating/airless,
/area/external/shuttle/station/centcom_ferry)
"bi" = (
/obj/structure/shuttle/engine/heater,
/turf/open/floor/plating/airless,
/area/external/shuttle/station/centcom_ferry)
"bj" = (
/obj/structure/shuttle/engine/propulsion/right,
/turf/open/floor/plating/airless,
/area/external/shuttle/station/centcom_ferry)
"Vs" = (
/obj/effect/spawner/structure/window/shuttle,
/obj/machinery/door/firedoor/border_only{
	dir = 4
	},
/turf/open/floor/plating,
/area/external/shuttle/station/centcom_ferry)

(1,1,1) = {"
aa
af
aa
ag
aa
aa
ag
ag
aa
aa
aa
aa
aa
aa
ab
aa
"}
(2,1,1) = {"
aa
af
af
aj
af
af
aa
ag
aa
aa
ab
aa
aa
aa
ac
aa
"}
(3,1,1) = {"
ab
af
ag
ag
am
af
aa
ag
aa
ag
ac
ag
aa
ag
ag
aa
"}
(4,1,1) = {"
ac
af
bh
bh
an
aq
as
aB
as
as
aX
bh
bh
bh
bi
bj
"}
(5,1,1) = {"
ad
aM
ai
ak
ao
ak
ak
ak
ak
aP
aX
ae
be
bh
bi
bj
"}
(6,1,1) = {"
aa
ad
aM
al
ap
ap
at
ap
aL
aQ
ap
aL
be
bh
aM
ad
"}
(7,1,1) = {"
aa
aa
ad
ad
aM
ar
au
au
au
au
au
aL
bf
aM
ad
aa
"}
(8,1,1) = {"
aa
aa
aa
aa
ad
ar
au
au
au
aR
au
bb
bg
ad
aa
aa
"}
(9,1,1) = {"
aa
aa
aa
aa
ap
ap
ah
ax
ax
az
ax
aC
aM
ad
aa
aa
"}
(10,1,1) = {"
aa
aa
aa
aa
aa
ap
au
aD
aD
aD
aD
bd
ad
aa
aa
aa
"}
(11,1,1) = {"
aa
aa
aa
aa
aa
ap
ap
aD
aD
aD
aD
aM
ad
aa
aa
aa
"}
(12,1,1) = {"
aa
aa
aa
aa
aa
aa
ap
aD
aD
aD
aD
ad
aa
aa
aa
aa
"}
(13,1,1) = {"
aa
aa
aa
aa
aa
aa
ap
aE
aN
aE
aM
ad
aa
aa
aa
aa
"}
(14,1,1) = {"
aa
aa
aa
aa
aa
aa
aw
aE
aN
aE
ad
aa
aa
aa
aa
aa
"}
(15,1,1) = {"
aa
aa
aa
aa
aa
aa
aw
ay
ay
ay
ad
aa
aa
aa
aa
aa
"}
(16,1,1) = {"
aa
aa
aa
aa
aa
aa
ad
ak
aE
ak
aY
aa
aa
aa
aa
aa
"}
(17,1,1) = {"
aa
aa
aa
aa
aa
aa
ad
aF
aE
aT
aw
aa
aa
aa
aa
aa
"}
(18,1,1) = {"
aa
aa
aa
aa
aa
aa
ad
aG
aE
aU
ad
aa
aa
aa
aa
aa
"}
(19,1,1) = {"
aa
aa
aa
aa
aa
aa
ad
aH
aE
aV
ad
aa
aa
aa
aa
aa
"}
(20,1,1) = {"
aa
aa
aa
aa
aa
aa
av
aI
aE
aW
aA
aa
aa
aa
aa
aa
"}
(21,1,1) = {"
aa
aa
aa
aa
aa
aa
ad
ak
aE
aW
ad
aa
aa
aa
aa
aa
"}
(22,1,1) = {"
aa
aa
aa
aa
aa
aa
ad
aJ
aE
aW
ad
aa
aa
aa
aa
aa
"}
(23,1,1) = {"
aa
aa
aa
aa
aa
aa
ad
aJ
aE
aW
ad
aa
aa
aa
aa
aa
"}
(24,1,1) = {"
aa
aa
aa
aa
aa
aa
av
aJ
aE
aW
aA
aa
aa
aa
aa
aa
"}
(25,1,1) = {"
aa
aa
aa
aa
aa
aa
ad
aJ
aE
aW
ad
aa
aa
aa
aa
aa
"}
(26,1,1) = {"
aa
aa
aa
aa
aa
aa
ad
aK
aE
aW
ad
aa
aa
aa
aa
aa
"}
(27,1,1) = {"
aa
aa
aa
aa
aa
aa
ad
Vs
aO
Vs
ad
aa
aa
aa
aa
aa
"}
