//MAP CONVERTED BY dmm2tgm.py THIS HEADER COMMENT PREVENTS RECONVERSION, DO NOT REMOVE
"a" = (
/turf/template_noop,
/area/template_noop)
"b" = (
/turf/closed/wall/mineral/titanium,
/area/external/shuttle/station/centcom_ferry)
"c" = (
/obj/effect/spawner/structure/window/shuttle,
/obj/machinery/door/firedoor/border_only{
	dir = 1
	},
/turf/open/floor/plating,
/area/external/shuttle/station/centcom_ferry)
"d" = (
/obj/machinery/door/airlock/external,
/obj/machinery/door/firedoor/border_only{
	dir = 1
	},
/obj/machinery/door/firedoor/border_only,
/turf/open/floor/pod/dark,
/area/external/shuttle/station/centcom_ferry)
"e" = (
/obj/structure/shuttle/engine/propulsion/left{
	dir = 8
	},
/turf/open/floor/plating/airless,
/area/external/shuttle/station/centcom_ferry)
"f" = (
/obj/structure/shuttle/engine/heater{
	dir = 8
	},
/obj/structure/window/reinforced,
/turf/open/floor/plating/airless,
/area/external/shuttle/station/centcom_ferry)
"g" = (
/obj/structure/chair/comfy/shuttle,
/turf/open/floor/pod/dark,
/area/external/shuttle/station/centcom_ferry)
"h" = (
/obj/machinery/light{
	dir = 1
	},
/turf/open/floor/pod/light,
/area/external/shuttle/station/centcom_ferry)
"i" = (
/turf/open/floor/pod/light,
/area/external/shuttle/station/centcom_ferry)
"j" = (
/obj/structure/shuttle/engine/heater{
	dir = 8
	},
/obj/structure/window/reinforced{
	dir = 4
	},
/turf/open/floor/plating/airless,
/area/external/shuttle/station/centcom_ferry)
"k" = (
/obj/machinery/light/small,
/turf/open/floor/pod/light,
/area/external/shuttle/station/centcom_ferry)
"l" = (
/obj/machinery/door/airlock/titanium,
/obj/machinery/door/firedoor/border_only{
	dir = 4
	},
/obj/machinery/door/firedoor/border_only{
	dir = 8
	},
/turf/open/floor/pod/light,
/area/external/shuttle/station/centcom_ferry)
"m" = (
/obj/machinery/computer/shuttle/ferry/request{
	dir = 8
	},
/turf/open/floor/pod/dark,
/area/external/shuttle/station/centcom_ferry)
"n" = (
/obj/machinery/door/airlock/titanium,
/obj/docking_port/mobile{
	dir = 8;
	dwidth = 2;
	height = 13;
	shuttle_id = "ferry";
	name = "ferry shuttle";
	port_direction = 1;
	preferred_direction = 4;
	width = 5
	},
/obj/machinery/door/firedoor/border_only{
	dir = 4
	},
/obj/machinery/door/firedoor/border_only{
	dir = 8
	},
/turf/open/floor/pod/light,
/area/external/shuttle/station/centcom_ferry)
"o" = (
/obj/structure/shuttle/engine/heater{
	dir = 8
	},
/obj/structure/window/reinforced{
	dir = 1;
	pixel_y = 1
	},
/turf/open/floor/plating/airless,
/area/external/shuttle/station/centcom_ferry)
"p" = (
/obj/structure/chair/comfy/shuttle{
	dir = 1
	},
/turf/open/floor/pod/dark,
/area/external/shuttle/station/centcom_ferry)
"q" = (
/obj/machinery/light,
/turf/open/floor/pod/light,
/area/external/shuttle/station/centcom_ferry)
"r" = (
/obj/machinery/door/airlock/external,
/obj/machinery/door/firedoor/border_only{
	dir = 1
	},
/obj/machinery/door/firedoor/border_only,
/turf/open/floor/pod/light,
/area/external/shuttle/station/centcom_ferry)
"L" = (
/obj/effect/spawner/structure/window/shuttle,
/obj/machinery/door/firedoor/border_only{
	dir = 4
	},
/turf/open/floor/plating,
/area/external/shuttle/station/centcom_ferry)
"V" = (
/obj/effect/spawner/structure/window/shuttle,
/obj/machinery/door/firedoor/border_only,
/turf/open/floor/plating,
/area/external/shuttle/station/centcom_ferry)

(1,1,1) = {"
a
a
e
a
a
"}
(2,1,1) = {"
a
e
j
e
a
"}
(3,1,1) = {"
a
f
i
o
a
"}
(4,1,1) = {"
a
b
k
b
a
"}
(5,1,1) = {"
b
b
l
b
b
"}
(6,1,1) = {"
c
g
i
p
V
"}
(7,1,1) = {"
b
g
i
p
b
"}
(8,1,1) = {"
b
h
i
i
b
"}
(9,1,1) = {"
d
i
m
i
r
"}
(10,1,1) = {"
b
i
i
q
b
"}
(11,1,1) = {"
b
g
i
p
b
"}
(12,1,1) = {"
c
g
i
p
V
"}
(13,1,1) = {"
b
L
n
L
b
"}
