//MAP CONVERTED BY dmm2tgm.py THIS HEADER COMMENT PREVENTS RECONVERSION, DO NOT REMOVE
"a" = (
/turf/template_noop,
/area/template_noop)
"b" = (
/obj/structure/shuttle/engine/propulsion{
	dir = 8
	},
/turf/open/floor/plating/airless,
/area/external/shuttle/misc/fugitive_hunter)
"c" = (
/turf/closed/wall/mineral/titanium,
/area/external/shuttle/misc/fugitive_hunter)
"d" = (
/obj/effect/spawner/structure/window/shuttle,
/obj/machinery/door/firedoor/border_only{
	dir = 1
	},
/turf/open/floor/plating,
/area/external/shuttle/misc/fugitive_hunter)
"f" = (
/obj/structure/fans/tiny,
/obj/machinery/door/poddoor/shutters{
	id = "Interpolship"
	},
/obj/machinery/door/firedoor/border_only{
	dir = 4
	},
/obj/machinery/door/firedoor/border_only{
	dir = 8
	},
/turf/open/floor/mineral/titanium/blue,
/area/external/shuttle/misc/fugitive_hunter)
"g" = (
/obj/effect/turf_decal/stripes{
	dir = 8;
	icon_state = "warningline"
	},
/turf/open/floor/mineral/titanium/blue,
/area/external/shuttle/misc/fugitive_hunter)
"h" = (
/obj/structure/chair/comfy/shuttle{
	dir = 1;
	icon_state = "shuttle_chair"
	},
/obj/effect/mob_spawn/human/fugitive/spacepol{
	dir = 1;
	icon_state = "sleeper"
	},
/turf/open/floor/mineral/titanium/blue,
/area/external/shuttle/misc/fugitive_hunter)
"i" = (
/turf/open/floor/mineral/titanium/blue,
/area/external/shuttle/misc/fugitive_hunter)
"j" = (
/obj/structure/closet/crate,
/obj/effect/turf_decal/box,
/turf/open/floor/mineral/titanium/blue,
/area/external/shuttle/misc/fugitive_hunter)
"k" = (
/obj/machinery/computer/shuttle/hunter{
	dir = 8
	},
/turf/open/floor/mineral/titanium/blue,
/area/external/shuttle/misc/fugitive_hunter)
"l" = (
/obj/effect/spawner/structure/window/shuttle,
/obj/machinery/door/firedoor/border_only{
	dir = 4
	},
/turf/open/floor/plating,
/area/external/shuttle/misc/fugitive_hunter)
"m" = (
/obj/structure/fans/tiny,
/obj/docking_port/stationary{
	dir = 4;
	dwidth = 3;
	height = 12;
	shuttle_id = "pirateship_home";
	name = "Deep Space";
	width = 7
	},
/obj/docking_port/mobile{
	dheight = 0;
	dir = 4;
	dwidth = 3;
	height = 12;
	shuttle_id = "huntership";
	name = "hunter shuttle";
	rechargeTime = 1800;
	width = 7
	},
/obj/machinery/door/poddoor/shutters{
	id = "Interpolship"
	},
/obj/machinery/door/firedoor/border_only{
	dir = 4
	},
/obj/machinery/door/firedoor/border_only{
	dir = 8
	},
/turf/open/floor/mineral/titanium/blue,
/area/external/shuttle/misc/fugitive_hunter)
"n" = (
/obj/effect/turf_decal/stripes{
	dir = 8;
	icon_state = "warningline"
	},
/obj/effect/turf_decal/caution{
	dir = 4;
	icon_state = "caution"
	},
/turf/open/floor/mineral/titanium/blue,
/area/external/shuttle/misc/fugitive_hunter)
"o" = (
/obj/machinery/door/airlock/titanium,
/obj/machinery/door/firedoor/border_only{
	dir = 4
	},
/obj/machinery/door/firedoor/border_only{
	dir = 8
	},
/turf/open/floor/mineral/titanium/blue,
/area/external/shuttle/misc/fugitive_hunter)
"p" = (
/obj/structure/chair/comfy/shuttle{
	dir = 4
	},
/turf/open/floor/mineral/titanium/blue,
/area/external/shuttle/misc/fugitive_hunter)
"q" = (
/obj/structure/table,
/obj/effect/mob_spawn/human/fugitive/spacepol{
	dir = 8;
	icon_state = "sleeper"
	},
/turf/open/floor/mineral/titanium/blue,
/area/external/shuttle/misc/fugitive_hunter)
"r" = (
/obj/machinery/button/door{
	id = "Interpolship";
	pixel_y = 26
	},
/obj/effect/turf_decal/stripes{
	dir = 8;
	icon_state = "warningline"
	},
/obj/structure/table/reinforced,
/obj/item/clothing/suit/space,
/obj/item/clothing/suit/space,
/obj/item/clothing/suit/space,
/obj/item/clothing/head/helmet/space,
/obj/item/clothing/head/helmet/space,
/obj/item/clothing/head/helmet/space,
/obj/item/clothing/mask/gas,
/obj/item/clothing/mask/gas,
/obj/item/clothing/mask/gas,
/turf/open/floor/mineral/titanium/blue,
/area/external/shuttle/misc/fugitive_hunter)
"s" = (
/obj/structure/chair/comfy/shuttle,
/turf/open/floor/mineral/titanium/blue,
/area/external/shuttle/misc/fugitive_hunter)
"t" = (
/obj/effect/turf_decal/delivery,
/turf/open/floor/mineral/titanium/blue,
/area/external/shuttle/misc/fugitive_hunter)
"u" = (
/obj/effect/turf_decal/loading_area{
	dir = 4;
	icon_state = "loadingarea"
	},
/turf/open/floor/mineral/titanium/blue,
/area/external/shuttle/misc/fugitive_hunter)
"v" = (
/obj/machinery/fugitive_capture,
/turf/open/floor/mineral/titanium/blue,
/area/external/shuttle/misc/fugitive_hunter)
"w" = (
/obj/machinery/computer/camera_advanced/shuttle_docker/syndicate/hunter{
	dir = 8;
	jumpto_ports = list("huntership_home" = 1);
	view_range = 7;
	x_offset = 6
	},
/turf/open/floor/mineral/titanium/blue,
/area/external/shuttle/misc/fugitive_hunter)
"x" = (
/obj/effect/spawner/structure/window/shuttle,
/obj/machinery/door/firedoor/border_only,
/turf/open/floor/plating,
/area/external/shuttle/misc/fugitive_hunter)

(1,1,1) = {"
a
c
f
m
f
c
a
"}
(2,1,1) = {"
a
c
r
n
g
c
a
"}
(3,1,1) = {"
a
c
s
i
h
c
a
"}
(4,1,1) = {"
b
c
s
i
h
c
b
"}
(5,1,1) = {"
c
c
s
i
h
c
c
"}
(6,1,1) = {"
a
d
t
i
i
x
a
"}
(7,1,1) = {"
a
d
u
i
j
x
a
"}
(8,1,1) = {"
a
c
v
i
j
c
a
"}
(9,1,1) = {"
b
c
c
o
c
c
b
"}
(10,1,1) = {"
c
c
i
p
i
c
c
"}
(11,1,1) = {"
a
d
w
q
k
x
a
"}
(12,1,1) = {"
a
c
l
l
l
c
a
"}
