//MAP CONVERTED BY dmm2tgm.py THIS HEADER COMMENT PREVENTS RECONVERSION, DO NOT REMOVE
"aa" = (
/turf/template_noop,
/area/template_noop)
"ab" = (
/obj/machinery/porta_turret/syndicate/shuttle{
	dir = 9
	},
/turf/closed/wall/r_wall/syndicate,
/area/external/shuttle/misc/nukeop_dropship)
"ae" = (
/obj/structure/window/plastitanium,
/obj/machinery/door/poddoor/shutters{
	id = "syndieshutters";
	name = "blast shutters"
	},
/obj/structure/grille,
/obj/machinery/door/firedoor/border_only{
	dir = 1
	},
/obj/machinery/door/firedoor/border_only,
/turf/open/floor/plating,
/area/external/shuttle/misc/nukeop_dropship)
"ag" = (
/obj/machinery/computer/med_data/syndie,
/obj/effect/turf_decal/bot_white,
/turf/open/floor/plasteel/dark,
/area/external/shuttle/misc/nukeop_dropship)
"ah" = (
/obj/machinery/computer/crew/syndie,
/obj/effect/turf_decal/bot_white,
/turf/open/floor/plasteel/dark,
/area/external/shuttle/misc/nukeop_dropship)
"ai" = (
/obj/machinery/computer/camera_advanced/shuttle_docker/syndicate,
/obj/effect/turf_decal/bot_white,
/turf/open/floor/plasteel/dark,
/area/external/shuttle/misc/nukeop_dropship)
"aj" = (
/obj/machinery/computer/shuttle/syndicate,
/obj/effect/turf_decal/bot_white,
/turf/open/floor/plasteel/dark,
/area/external/shuttle/misc/nukeop_dropship)
"ak" = (
/obj/structure/table/reinforced,
/turf/open/floor/plasteel/dark,
/area/external/shuttle/misc/nukeop_dropship)
"al" = (
/obj/machinery/computer/camera_advanced/syndie,
/obj/effect/turf_decal/bot_white,
/turf/open/floor/plasteel/dark,
/area/external/shuttle/misc/nukeop_dropship)
"am" = (
/obj/machinery/computer/secure_data/syndie,
/obj/effect/turf_decal/bot_white,
/turf/open/floor/plasteel/dark,
/area/external/shuttle/misc/nukeop_dropship)
"an" = (
/obj/structure/table/reinforced,
/obj/machinery/status_display/evac{
	pixel_x = -32
	},
/obj/item/clipboard,
/obj/machinery/light{
	dir = 8
	},
/obj/item/folder/red,
/obj/item/toy/figure/syndie,
/obj/effect/turf_decal/tile/neutral{
	dir = 1
	},
/obj/effect/turf_decal/tile/neutral,
/obj/effect/turf_decal/tile/neutral{
	dir = 4
	},
/obj/effect/turf_decal/tile/neutral{
	dir = 8
	},
/turf/open/floor/plasteel/dark,
/area/external/shuttle/misc/nukeop_dropship)
"ao" = (
/obj/structure/chair/office/dark{
	dir = 8;
	name = "tactical swivel chair"
	},
/turf/open/floor/plasteel/dark,
/area/external/shuttle/misc/nukeop_dropship)
"ap" = (
/turf/open/floor/plasteel/dark,
/area/external/shuttle/misc/nukeop_dropship)
"aq" = (
/obj/structure/chair/office/dark{
	dir = 1;
	name = "tactical swivel chair"
	},
/obj/machinery/button/door{
	id = "syndieshutters";
	name = "Cockpit View Control";
	pixel_x = 32;
	pixel_y = 32;
	req_access = list("syndicate")
	},
/turf/open/floor/plasteel/dark,
/area/external/shuttle/misc/nukeop_dropship)
"ar" = (
/obj/structure/chair/office/dark{
	dir = 4;
	name = "tactical swivel chair"
	},
/turf/open/floor/plasteel/dark,
/area/external/shuttle/misc/nukeop_dropship)
"as" = (
/obj/structure/table/reinforced,
/obj/machinery/status_display/ai{
	pixel_x = 32
	},
/obj/item/storage/fancy/donut_box,
/obj/machinery/light{
	dir = 4
	},
/obj/effect/turf_decal/tile/neutral{
	dir = 1
	},
/obj/effect/turf_decal/tile/neutral,
/obj/effect/turf_decal/tile/neutral{
	dir = 4
	},
/obj/effect/turf_decal/tile/neutral{
	dir = 8
	},
/turf/open/floor/plasteel/dark,
/area/external/shuttle/misc/nukeop_dropship)
"at" = (
/obj/effect/turf_decal/tile/neutral,
/obj/effect/turf_decal/tile/neutral{
	dir = 8
	},
/turf/open/floor/plasteel/dark,
/area/external/shuttle/misc/nukeop_dropship)
"au" = (
/obj/machinery/status_display/evac,
/turf/closed/wall/r_wall/syndicate,
/area/external/shuttle/misc/nukeop_dropship)
"av" = (
/obj/machinery/door/airlock/hatch{
	name = "Cockpit"
	},
/obj/effect/turf_decal/tile/neutral{
	dir = 1
	},
/obj/effect/turf_decal/tile/neutral,
/obj/effect/turf_decal/tile/neutral{
	dir = 4
	},
/obj/effect/turf_decal/tile/neutral{
	dir = 8
	},
/obj/machinery/door/firedoor/border_only{
	dir = 1
	},
/obj/machinery/door/firedoor/border_only,
/obj/effect/mapping_helpers/airlock/access/all/syndicate/general,
/turf/open/floor/plasteel/dark,
/area/external/shuttle/misc/nukeop_dropship)
"ay" = (
/obj/structure/table/reinforced,
/obj/item/stack/cable_coil/white,
/obj/item/stack/cable_coil/white,
/obj/item/crowbar/red,
/obj/effect/turf_decal/tile/neutral{
	dir = 1
	},
/obj/effect/turf_decal/tile/neutral,
/obj/effect/turf_decal/tile/neutral{
	dir = 4
	},
/obj/effect/turf_decal/tile/neutral{
	dir = 8
	},
/turf/open/floor/plasteel/dark,
/area/external/shuttle/misc/nukeop_dropship)
"aA" = (
/obj/structure/table/reinforced,
/obj/item/storage/box/handcuffs{
	pixel_x = 3;
	pixel_y = 3
	},
/obj/item/storage/box/zipties,
/obj/effect/turf_decal/tile/neutral{
	dir = 1
	},
/obj/effect/turf_decal/tile/neutral,
/obj/effect/turf_decal/tile/neutral{
	dir = 4
	},
/obj/effect/turf_decal/tile/neutral{
	dir = 8
	},
/turf/open/floor/plasteel/dark,
/area/external/shuttle/misc/nukeop_dropship)
"aB" = (
/turf/closed/wall/r_wall/syndicate,
/area/external/shuttle/misc/nukeop_dropship)
"aC" = (
/obj/structure/chair/comfy/shuttle{
	dir = 4;
	name = "tactical chair"
	},
/obj/effect/turf_decal/tile/neutral{
	dir = 1
	},
/obj/effect/turf_decal/tile/neutral,
/obj/effect/turf_decal/tile/neutral{
	dir = 4
	},
/obj/effect/turf_decal/tile/neutral{
	dir = 8
	},
/turf/open/floor/plasteel/dark,
/area/external/shuttle/misc/nukeop_dropship)
"aE" = (
/obj/structure/chair/comfy/shuttle{
	dir = 8;
	name = "tactical chair"
	},
/obj/effect/turf_decal/tile/neutral{
	dir = 1
	},
/obj/effect/turf_decal/tile/neutral,
/obj/effect/turf_decal/tile/neutral{
	dir = 4
	},
/obj/effect/turf_decal/tile/neutral{
	dir = 8
	},
/turf/open/floor/plasteel/dark,
/area/external/shuttle/misc/nukeop_dropship)
"aF" = (
/obj/machinery/porta_turret/syndicate/shuttle{
	dir = 5
	},
/turf/closed/wall/r_wall/syndicate,
/area/external/shuttle/misc/nukeop_dropship)
"aH" = (
/obj/structure/chair/comfy/shuttle{
	dir = 4;
	name = "tactical chair"
	},
/obj/machinery/light{
	dir = 8
	},
/obj/effect/turf_decal/tile/neutral{
	dir = 1
	},
/obj/effect/turf_decal/tile/neutral,
/obj/effect/turf_decal/tile/neutral{
	dir = 4
	},
/obj/effect/turf_decal/tile/neutral{
	dir = 8
	},
/turf/open/floor/plasteel/dark,
/area/external/shuttle/misc/nukeop_dropship)
"aI" = (
/obj/structure/chair/comfy/shuttle{
	dir = 8;
	name = "tactical chair"
	},
/obj/machinery/light{
	dir = 4
	},
/obj/effect/turf_decal/tile/neutral{
	dir = 1
	},
/obj/effect/turf_decal/tile/neutral,
/obj/effect/turf_decal/tile/neutral{
	dir = 4
	},
/obj/effect/turf_decal/tile/neutral{
	dir = 8
	},
/turf/open/floor/plasteel/dark,
/area/external/shuttle/misc/nukeop_dropship)
"aL" = (
/obj/machinery/suit_storage_unit/syndicate,
/obj/effect/turf_decal/stripes/line{
	dir = 5
	},
/turf/open/floor/mineral/plastitanium,
/area/external/shuttle/misc/nukeop_dropship)
"aN" = (
/obj/machinery/portable_atmospherics/canister/oxygen,
/obj/effect/turf_decal/bot_white,
/turf/open/floor/plasteel/dark,
/area/external/shuttle/misc/nukeop_dropship)
"aQ" = (
/obj/effect/spawner/structure/window/plastitanium,
/turf/open/floor/plating,
/area/external/shuttle/misc/nukeop_dropship)
"aR" = (
/obj/machinery/suit_storage_unit/syndicate,
/obj/effect/turf_decal/stripes/line{
	dir = 4
	},
/turf/open/floor/mineral/plastitanium,
/area/external/shuttle/misc/nukeop_dropship)
"aS" = (
/obj/structure/tank_dispenser/oxygen,
/obj/effect/turf_decal/bot_white,
/turf/open/floor/plasteel/dark,
/area/external/shuttle/misc/nukeop_dropship)
"aT" = (
/obj/effect/turf_decal/stripes/line{
	dir = 8
	},
/turf/open/floor/mineral/plastitanium/red,
/area/external/shuttle/misc/nukeop_dropship)
"aU" = (
/obj/machinery/portable_atmospherics/canister/oxygen,
/obj/machinery/light{
	dir = 4
	},
/obj/effect/turf_decal/bot_white,
/turf/open/floor/plasteel/dark,
/area/external/shuttle/misc/nukeop_dropship)
"aV" = (
/obj/machinery/door/airlock/external{
	name = "Ready Room"
	},
/obj/effect/turf_decal/tile/neutral{
	dir = 1
	},
/obj/effect/turf_decal/tile/neutral,
/obj/effect/turf_decal/tile/neutral{
	dir = 4
	},
/obj/effect/turf_decal/tile/neutral{
	dir = 8
	},
/obj/machinery/door/firedoor/border_only{
	dir = 1
	},
/obj/machinery/door/firedoor/border_only,
/obj/effect/mapping_helpers/airlock/access/all/syndicate/general,
/turf/open/floor/plasteel/dark,
/area/external/shuttle/misc/nukeop_dropship)
"aW" = (
/obj/machinery/door/airlock/external{
	name = "E.V.A. Gear Storage"
	},
/obj/effect/turf_decal/tile/neutral{
	dir = 1
	},
/obj/effect/turf_decal/tile/neutral,
/obj/effect/turf_decal/tile/neutral{
	dir = 4
	},
/obj/effect/turf_decal/tile/neutral{
	dir = 8
	},
/obj/machinery/door/firedoor/border_only{
	dir = 4
	},
/obj/machinery/door/firedoor/border_only{
	dir = 8
	},
/obj/effect/mapping_helpers/airlock/access/all/syndicate/general,
/turf/open/floor/plasteel/dark,
/area/external/shuttle/misc/nukeop_dropship)
"aX" = (
/obj/structure/chair/comfy/shuttle{
	dir = 4;
	name = "tactical chair"
	},
/obj/effect/turf_decal/bot_white,
/obj/machinery/light{
	dir = 8
	},
/turf/open/floor/plasteel/dark,
/area/external/shuttle/misc/nukeop_dropship)
"aY" = (
/obj/machinery/door/poddoor{
	id = "smindicate";
	name = "outer blast door"
	},
/obj/machinery/button/door{
	id = "smindicate";
	name = "external door control";
	pixel_y = 26;
	req_access = list("syndicate")
	},
/obj/docking_port/mobile{
	dheight = 1;
	dir = 8;
	dwidth = 12;
	height = 17;
	hidden = 1;
	shuttle_id = "syndicate";
	movement_force = list("KNOCKDOWN" = 0, "THROW" = 0);
	name = "syndicate infiltrator";
	port_direction = 4;
	width = 23
	},
/obj/structure/fans/tiny,
/obj/effect/turf_decal/stripes/line{
	dir = 1
	},
/obj/machinery/door/firedoor/border_only{
	dir = 8
	},
/turf/open/floor/plating,
/area/external/shuttle/misc/nukeop_dropship)
"ba" = (
/obj/machinery/door/airlock/external,
/obj/effect/turf_decal/tile/neutral{
	dir = 1
	},
/obj/effect/turf_decal/tile/neutral,
/obj/effect/turf_decal/tile/neutral{
	dir = 4
	},
/obj/effect/turf_decal/tile/neutral{
	dir = 8
	},
/obj/machinery/door/firedoor/border_only{
	dir = 4
	},
/obj/machinery/door/firedoor/border_only{
	dir = 8
	},
/obj/effect/mapping_helpers/airlock/access/all/syndicate/general,
/turf/open/floor/plasteel/dark,
/area/external/shuttle/misc/nukeop_dropship)
"bd" = (
/obj/effect/turf_decal/stripes/line{
	dir = 8
	},
/obj/structure/sign/warning/vacuum/external{
	layer = 4;
	pixel_x = 32
	},
/turf/open/floor/mineral/plastitanium/red,
/area/external/shuttle/misc/nukeop_dropship)
"be" = (
/obj/machinery/suit_storage_unit/syndicate,
/obj/effect/turf_decal/stripes/line{
	dir = 6
	},
/turf/open/floor/mineral/plastitanium,
/area/external/shuttle/misc/nukeop_dropship)
"bi" = (
/obj/structure/rack,
/obj/effect/turf_decal/bot_white,
/obj/effect/turf_decal/stripes/line{
	dir = 10
	},
/obj/item/clothing/suit/space/syndicate,
/obj/item/clothing/head/helmet/space/syndicate,
/turf/open/floor/mineral/plastitanium/red,
/area/external/shuttle/misc/nukeop_dropship)
"bj" = (
/turf/closed/wall/r_wall/syndicate/nodiagonal,
/area/external/shuttle/misc/nukeop_dropship)
"bk" = (
/obj/machinery/status_display/ai,
/turf/closed/wall/r_wall/syndicate,
/area/external/shuttle/misc/nukeop_dropship)
"bl" = (
/obj/machinery/door/airlock/hatch,
/obj/effect/turf_decal/stripes/line{
	dir = 1
	},
/obj/machinery/door/firedoor/border_only{
	dir = 4
	},
/obj/machinery/door/firedoor/border_only{
	dir = 8
	},
/obj/effect/mapping_helpers/airlock/access/all/syndicate/general,
/turf/open/floor/mineral/plastitanium/red,
/area/external/shuttle/misc/nukeop_dropship)
"bo" = (
/obj/machinery/nuclearbomb/syndicate{
	anchored = 1
	},
/obj/machinery/door/window{
	dir = 1
	},
/turf/open/floor/circuit/red,
/area/external/shuttle/misc/nukeop_dropship)
"bq" = (
/obj/machinery/sleeper/syndie{
	dir = 4
	},
/obj/effect/turf_decal/bot_white,
/turf/open/floor/plasteel/dark,
/area/external/shuttle/misc/nukeop_dropship)
"bs" = (
/obj/machinery/light{
	dir = 1
	},
/turf/open/floor/plasteel/dark,
/area/external/shuttle/misc/nukeop_dropship)
"bt" = (
/obj/item/reagent_containers/glass/bottle/epinephrine{
	pixel_x = 6
	},
/obj/item/reagent_containers/glass/bottle/charcoal{
	pixel_x = -3
	},
/obj/item/reagent_containers/glass/bottle/epinephrine{
	pixel_x = -3;
	pixel_y = 8
	},
/obj/item/reagent_containers/glass/bottle/charcoal{
	pixel_x = 6;
	pixel_y = 8
	},
/obj/item/reagent_containers/syringe/epinephrine{
	pixel_x = 3;
	pixel_y = -2
	},
/obj/item/reagent_containers/syringe/epinephrine{
	pixel_x = 4;
	pixel_y = 1
	},
/obj/item/reagent_containers/syringe/epinephrine{
	pixel_x = -2;
	pixel_y = 5
	},
/obj/item/reagent_containers/syringe/epinephrine{
	pixel_x = 2;
	pixel_y = 8
	},
/obj/structure/table/reinforced,
/obj/effect/turf_decal/bot_white,
/turf/open/floor/plasteel/dark,
/area/external/shuttle/misc/nukeop_dropship)
"bu" = (
/obj/structure/table/reinforced,
/obj/item/stack/medical/gauze,
/obj/item/stack/medical/bruise_pack,
/obj/item/stack/medical/ointment,
/obj/effect/turf_decal/bot_white,
/turf/open/floor/plasteel/dark,
/area/external/shuttle/misc/nukeop_dropship)
"bv" = (
/obj/effect/turf_decal/tile/neutral{
	dir = 1
	},
/obj/effect/turf_decal/tile/neutral,
/obj/effect/turf_decal/tile/neutral{
	dir = 4
	},
/obj/effect/turf_decal/tile/neutral{
	dir = 8
	},
/obj/machinery/mass_driver{
	dir = 4;
	id = "syndiedriver"
	},
/obj/effect/turf_decal/delivery/white,
/turf/open/floor/plasteel/dark,
/area/external/shuttle/misc/nukeop_dropship)
"bw" = (
/obj/effect/turf_decal/tile/neutral,
/obj/effect/turf_decal/tile/neutral{
	dir = 1
	},
/obj/effect/turf_decal/tile/neutral{
	dir = 4
	},
/obj/effect/turf_decal/tile/neutral{
	dir = 8
	},
/obj/effect/turf_decal/bot_white,
/turf/open/floor/plasteel/dark,
/area/external/shuttle/misc/nukeop_dropship)
"bx" = (
/obj/item/stock_parts/cell/high{
	pixel_x = -3;
	pixel_y = 3
	},
/obj/item/stock_parts/cell/high,
/obj/structure/table/reinforced,
/turf/open/floor/plasteel/dark,
/area/external/shuttle/misc/nukeop_dropship)
"by" = (
/obj/item/screwdriver{
	pixel_y = 9
	},
/obj/item/assembly/voice{
	pixel_y = 3
	},
/obj/structure/table/reinforced,
/turf/open/floor/plasteel/dark,
/area/external/shuttle/misc/nukeop_dropship)
"bz" = (
/obj/item/wrench,
/obj/item/assembly/infra,
/obj/structure/table/reinforced,
/obj/machinery/light{
	dir = 1
	},
/turf/open/floor/plasteel/dark,
/area/external/shuttle/misc/nukeop_dropship)
"bA" = (
/obj/item/assembly/signaler,
/obj/item/assembly/signaler,
/obj/item/assembly/prox_sensor{
	pixel_x = -8;
	pixel_y = 4
	},
/obj/item/assembly/prox_sensor{
	pixel_x = -8;
	pixel_y = 4
	},
/obj/structure/table/reinforced,
/turf/open/floor/plasteel/dark,
/area/external/shuttle/misc/nukeop_dropship)
"bB" = (
/obj/item/weldingtool/largetank{
	pixel_y = 3
	},
/obj/item/multitool,
/obj/structure/table/reinforced,
/turf/open/floor/plasteel/dark,
/area/external/shuttle/misc/nukeop_dropship)
"bC" = (
/obj/structure/bed/roller,
/obj/machinery/iv_drip,
/obj/effect/turf_decal/bot_white,
/turf/open/floor/plasteel/dark,
/area/external/shuttle/misc/nukeop_dropship)
"bE" = (
/obj/machinery/light{
	dir = 8
	},
/obj/effect/turf_decal/tile/neutral{
	dir = 1
	},
/obj/effect/turf_decal/tile/neutral,
/obj/effect/turf_decal/tile/neutral{
	dir = 4
	},
/obj/effect/turf_decal/tile/neutral{
	dir = 8
	},
/turf/open/floor/plasteel/dark,
/area/external/shuttle/misc/nukeop_dropship)
"bI" = (
/obj/effect/turf_decal/stripes/line{
	dir = 9
	},
/turf/open/floor/mineral/plastitanium/red,
/area/external/shuttle/misc/nukeop_dropship)
"bK" = (
/obj/effect/turf_decal/tile/neutral{
	dir = 1
	},
/obj/effect/turf_decal/tile/neutral,
/obj/effect/turf_decal/tile/neutral{
	dir = 4
	},
/obj/effect/turf_decal/tile/neutral{
	dir = 8
	},
/obj/structure/extinguisher_cabinet{
	pixel_x = -30
	},
/turf/open/floor/plasteel/dark,
/area/external/shuttle/misc/nukeop_dropship)
"bN" = (
/obj/effect/turf_decal/stripes/line{
	dir = 1
	},
/turf/open/floor/mineral/plastitanium/red,
/area/external/shuttle/misc/nukeop_dropship)
"bO" = (
/obj/effect/turf_decal/stripes/line{
	dir = 5
	},
/turf/open/floor/mineral/plastitanium/red,
/area/external/shuttle/misc/nukeop_dropship)
"bP" = (
/obj/effect/turf_decal/tile/neutral{
	dir = 1
	},
/obj/effect/turf_decal/tile/neutral,
/obj/effect/turf_decal/tile/neutral{
	dir = 4
	},
/obj/effect/turf_decal/tile/neutral{
	dir = 8
	},
/turf/open/floor/plasteel/dark,
/area/external/shuttle/misc/nukeop_dropship)
"bQ" = (
/obj/structure/closet/syndicate/personal,
/obj/effect/turf_decal/bot_white,
/turf/open/floor/plasteel/dark,
/area/external/shuttle/misc/nukeop_dropship)
"bR" = (
/obj/structure/table/reinforced,
/obj/item/reagent_containers/glass/beaker/large,
/obj/item/reagent_containers/glass/beaker,
/obj/item/reagent_containers/dropper,
/obj/effect/turf_decal/tile/neutral,
/obj/effect/turf_decal/tile/neutral{
	dir = 8
	},
/turf/open/floor/plasteel/dark,
/area/external/shuttle/misc/nukeop_dropship)
"bS" = (
/obj/effect/turf_decal/stripes/line{
	dir = 10
	},
/turf/open/floor/mineral/plastitanium/red,
/area/external/shuttle/misc/nukeop_dropship)
"bV" = (
/obj/effect/turf_decal/stripes/line,
/turf/open/floor/mineral/plastitanium/red,
/area/external/shuttle/misc/nukeop_dropship)
"bW" = (
/obj/effect/turf_decal/stripes/line{
	dir = 6
	},
/turf/open/floor/mineral/plastitanium/red,
/area/external/shuttle/misc/nukeop_dropship)
"bX" = (
/obj/structure/closet/syndicate/nuclear,
/obj/effect/turf_decal/bot_white,
/turf/open/floor/plasteel/dark,
/area/external/shuttle/misc/nukeop_dropship)
"bY" = (
/obj/structure/window/reinforced{
	dir = 1
	},
/obj/item/bodypart/r_arm/robot,
/obj/item/bodypart/l_arm/robot,
/obj/structure/table/reinforced,
/obj/item/toy/plush/nukeplushie,
/obj/effect/turf_decal/tile/neutral,
/obj/effect/turf_decal/tile/neutral{
	dir = 8
	},
/turf/open/floor/plasteel/dark,
/area/external/shuttle/misc/nukeop_dropship)
"bZ" = (
/obj/machinery/door/window{
	dir = 1;
	name = "Surgery"
	},
/obj/effect/turf_decal/tile/neutral,
/obj/effect/turf_decal/tile/neutral{
	dir = 8
	},
/obj/effect/mapping_helpers/windoor/access/all/syndicate/general{
	dir = 1
	},
/turf/open/floor/plasteel/dark,
/area/external/shuttle/misc/nukeop_dropship)
"ca" = (
/obj/structure/window/reinforced{
	dir = 1
	},
/obj/effect/turf_decal/tile/neutral,
/obj/effect/turf_decal/tile/neutral{
	dir = 8
	},
/turf/open/floor/plasteel/dark,
/area/external/shuttle/misc/nukeop_dropship)
"cb" = (
/obj/structure/window/reinforced{
	dir = 8
	},
/obj/item/storage/firstaid/regular{
	pixel_x = 3;
	pixel_y = 3
	},
/obj/item/storage/firstaid/brute,
/obj/item/storage/firstaid/regular{
	pixel_x = -3;
	pixel_y = -3
	},
/obj/structure/table/reinforced,
/obj/effect/turf_decal/tile/neutral,
/obj/effect/turf_decal/tile/neutral{
	dir = 8
	},
/turf/open/floor/plasteel/dark,
/area/external/shuttle/misc/nukeop_dropship)
"cc" = (
/obj/item/storage/firstaid/regular{
	pixel_x = 3;
	pixel_y = 3
	},
/obj/item/storage/firstaid/fire,
/obj/item/storage/firstaid/regular{
	pixel_x = -3;
	pixel_y = -3
	},
/obj/structure/table/reinforced,
/obj/effect/turf_decal/tile/neutral,
/obj/effect/turf_decal/tile/neutral{
	dir = 8
	},
/turf/open/floor/plasteel/dark,
/area/external/shuttle/misc/nukeop_dropship)
"ce" = (
/obj/item/sbeacondrop/bomb{
	pixel_y = 5
	},
/obj/item/sbeacondrop/bomb,
/obj/structure/table/reinforced,
/obj/effect/turf_decal/tile/neutral,
/obj/effect/turf_decal/tile/neutral{
	dir = 8
	},
/turf/open/floor/plasteel/dark,
/area/external/shuttle/misc/nukeop_dropship)
"cf" = (
/obj/item/grenade/syndieminibomb{
	pixel_x = 4;
	pixel_y = 2
	},
/obj/item/grenade/syndieminibomb{
	pixel_x = -1
	},
/obj/structure/table/reinforced,
/obj/structure/window/reinforced{
	dir = 4
	},
/obj/item/grenade/plastic/c4,
/obj/item/grenade/plastic/c4,
/obj/item/grenade/plastic/c4,
/obj/item/grenade/plastic/c4,
/obj/item/grenade/plastic/c4,
/obj/effect/turf_decal/tile/neutral,
/obj/effect/turf_decal/tile/neutral{
	dir = 8
	},
/turf/open/floor/plasteel/dark,
/area/external/shuttle/misc/nukeop_dropship)
"ch" = (
/obj/machinery/door/window{
	dir = 1;
	name = "Technological Storage"
	},
/obj/effect/turf_decal/tile/neutral,
/obj/effect/turf_decal/tile/neutral{
	dir = 8
	},
/obj/effect/mapping_helpers/windoor/access/all/syndicate/general{
	dir = 1
	},
/turf/open/floor/plasteel/dark,
/area/external/shuttle/misc/nukeop_dropship)
"ci" = (
/obj/structure/window/reinforced{
	dir = 1
	},
/obj/structure/table/reinforced,
/obj/item/aicard,
/obj/effect/turf_decal/tile/neutral,
/obj/effect/turf_decal/tile/neutral{
	dir = 8
	},
/turf/open/floor/plasteel/dark,
/area/external/shuttle/misc/nukeop_dropship)
"cj" = (
/obj/item/surgicaldrill,
/obj/item/circular_saw,
/obj/structure/table/reinforced,
/obj/machinery/light{
	dir = 8
	},
/obj/effect/turf_decal/tile/neutral{
	dir = 1
	},
/obj/effect/turf_decal/tile/neutral,
/obj/effect/turf_decal/tile/neutral{
	dir = 4
	},
/obj/effect/turf_decal/tile/neutral{
	dir = 8
	},
/turf/open/floor/plasteel/dark,
/area/external/shuttle/misc/nukeop_dropship)
"ck" = (
/obj/structure/sink{
	dir = 4;
	pixel_x = 11
	},
/obj/structure/mirror{
	pixel_x = 30
	},
/obj/effect/turf_decal/tile/neutral{
	dir = 1
	},
/obj/effect/turf_decal/tile/neutral,
/obj/effect/turf_decal/tile/neutral{
	dir = 4
	},
/obj/effect/turf_decal/tile/neutral{
	dir = 8
	},
/turf/open/floor/plasteel/dark,
/area/external/shuttle/misc/nukeop_dropship)
"cl" = (
/obj/effect/spawner/structure/window/reinforced,
/turf/open/floor/plating,
/area/external/shuttle/misc/nukeop_dropship)
"cn" = (
/obj/machinery/light{
	dir = 4
	},
/obj/effect/turf_decal/tile/neutral{
	dir = 1
	},
/obj/effect/turf_decal/tile/neutral,
/obj/effect/turf_decal/tile/neutral{
	dir = 4
	},
/obj/effect/turf_decal/tile/neutral{
	dir = 8
	},
/turf/open/floor/plasteel/dark,
/area/external/shuttle/misc/nukeop_dropship)
"co" = (
/obj/item/cautery,
/obj/item/scalpel,
/obj/structure/table/reinforced,
/obj/effect/turf_decal/tile/neutral{
	dir = 1
	},
/obj/effect/turf_decal/tile/neutral,
/obj/effect/turf_decal/tile/neutral{
	dir = 4
	},
/obj/effect/turf_decal/tile/neutral{
	dir = 8
	},
/turf/open/floor/plasteel/dark,
/area/external/shuttle/misc/nukeop_dropship)
"cp" = (
/obj/structure/table/optable,
/obj/item/surgical_drapes,
/obj/effect/turf_decal/bot_white,
/turf/open/floor/plasteel/dark,
/area/external/shuttle/misc/nukeop_dropship)
"cq" = (
/obj/item/retractor,
/obj/item/hemostat,
/obj/structure/table/reinforced,
/obj/effect/turf_decal/tile/neutral{
	dir = 1
	},
/obj/effect/turf_decal/tile/neutral,
/obj/effect/turf_decal/tile/neutral{
	dir = 4
	},
/obj/effect/turf_decal/tile/neutral{
	dir = 8
	},
/turf/open/floor/plasteel/dark,
/area/external/shuttle/misc/nukeop_dropship)
"ct" = (
/obj/machinery/telecomms/allinone{
	intercept = 1
	},
/turf/open/floor/circuit/red,
/area/external/shuttle/misc/nukeop_dropship)
"cy" = (
/obj/structure/shuttle/engine/heater,
/obj/structure/window/reinforced{
	dir = 1
	},
/obj/effect/turf_decal/stripes/line,
/turf/open/floor/plating/airless,
/area/external/shuttle/misc/nukeop_dropship)
"cz" = (
/obj/structure/shuttle/engine/propulsion/left,
/obj/effect/turf_decal/stripes/line,
/turf/open/floor/plating/airless,
/area/external/shuttle/misc/nukeop_dropship)
"cA" = (
/obj/structure/shuttle/engine/propulsion,
/obj/effect/turf_decal/stripes/line,
/turf/open/floor/plating/airless,
/area/external/shuttle/misc/nukeop_dropship)
"cB" = (
/obj/structure/shuttle/engine/propulsion/right,
/obj/effect/turf_decal/stripes/line,
/turf/open/floor/plating/airless,
/area/external/shuttle/misc/nukeop_dropship)
"dp" = (
/obj/machinery/porta_turret/syndicate/shuttle{
	dir = 10
	},
/turf/closed/wall/r_wall/syndicate,
/area/external/shuttle/misc/nukeop_dropship)
"nG" = (
/obj/structure/window/reinforced{
	dir = 1
	},
/obj/effect/turf_decal/stripes/line{
	dir = 9
	},
/turf/open/floor/mineral/plastitanium/red,
/area/external/shuttle/misc/nukeop_dropship)
"pO" = (
/obj/effect/turf_decal/tile/neutral,
/obj/effect/turf_decal/tile/neutral{
	dir = 8
	},
/obj/structure/table/reinforced,
/obj/item/paper_bin,
/obj/item/pen/red,
/obj/item/stamp/syndiround,
/turf/open/floor/plasteel/dark,
/area/external/shuttle/misc/nukeop_dropship)
"rB" = (
/obj/structure/table/reinforced,
/obj/item/storage/toolbox/syndicate,
/obj/item/crowbar/red,
/obj/effect/turf_decal/tile/neutral{
	dir = 1
	},
/obj/effect/turf_decal/tile/neutral,
/obj/effect/turf_decal/tile/neutral{
	dir = 4
	},
/obj/effect/turf_decal/tile/neutral{
	dir = 8
	},
/turf/open/floor/plasteel/dark,
/area/external/shuttle/misc/nukeop_dropship)
"sI" = (
/obj/machinery/recharge_station/fullupgrade,
/turf/open/floor/circuit/red,
/area/external/shuttle/misc/nukeop_dropship)
"tZ" = (
/obj/effect/turf_decal/tile/neutral{
	dir = 8
	},
/obj/effect/turf_decal/tile/neutral{
	dir = 4
	},
/obj/effect/turf_decal/tile/neutral{
	dir = 1
	},
/obj/effect/turf_decal/tile/neutral,
/turf/closed/wall/r_wall/syndicate,
/area/external/shuttle/misc/nukeop_dropship)
"up" = (
/obj/effect/turf_decal/tile/neutral{
	dir = 1
	},
/obj/effect/turf_decal/tile/neutral,
/obj/effect/turf_decal/tile/neutral{
	dir = 4
	},
/obj/effect/turf_decal/tile/neutral{
	dir = 8
	},
/obj/structure/window/reinforced{
	dir = 1
	},
/turf/open/floor/plasteel/dark,
/area/external/shuttle/misc/nukeop_dropship)
"vv" = (
/obj/structure/reagent_dispensers/fueltank,
/obj/effect/turf_decal/bot_white,
/turf/open/floor/plasteel/dark,
/area/external/shuttle/misc/nukeop_dropship)
"Eh" = (
/obj/structure/fans/tiny,
/obj/machinery/door/poddoor{
	id = "syndiedriver";
	name = "outer blast door"
	},
/turf/open/floor/plating,
/area/external/shuttle/misc/nukeop_dropship)
"Mw" = (
/obj/effect/turf_decal/tile/neutral{
	dir = 1
	},
/obj/effect/turf_decal/tile/neutral,
/obj/effect/turf_decal/tile/neutral{
	dir = 4
	},
/obj/effect/turf_decal/tile/neutral{
	dir = 8
	},
/obj/machinery/door/window/brigdoor{
	dir = 1;
	name = "Mass Driver"
	},
/obj/machinery/computer/pod/old{
	density = 0;
	icon = 'icons/obj/airlock_machines.dmi';
	icon_state = "airlock_control_standby";
	id = "syndiedriver";
	name = "Mass Driver Controller";
	pixel_x = -24;
	req_access = list("syndicate")
	},
/obj/effect/mapping_helpers/windoor/access/all/syndicate/general{
	dir = 1
	},
/turf/open/floor/plasteel/dark,
/area/external/shuttle/misc/nukeop_dropship)
"MJ" = (
/obj/machinery/porta_turret/syndicate/shuttle{
	dir = 6
	},
/turf/closed/wall/r_wall/syndicate,
/area/external/shuttle/misc/nukeop_dropship)
"No" = (
/obj/effect/turf_decal/tile/neutral,
/obj/effect/turf_decal/tile/neutral{
	dir = 8
	},
/obj/machinery/photocopier,
/turf/open/floor/plasteel/dark,
/area/external/shuttle/misc/nukeop_dropship)
"Xg" = (
/obj/effect/turf_decal/bot_white,
/obj/structure/closet/syndicate,
/obj/item/melee/vxtvulhammer,
/obj/item/gun/energy/plasmacutter/adv,
/obj/item/gun/energy/plasmacutter/adv,
/obj/item/gun/energy/plasmacutter/adv,
/obj/item/gun/energy/plasmacutter/adv,
/obj/item/gun/energy/plasmacutter/adv,
/obj/item/stack/sheet/mineral/plasma{
	amount = 25
	},
/turf/open/floor/plasteel/dark,
/area/external/shuttle/misc/nukeop_dropship)

(1,1,1) = {"
aa
aa
aa
aa
aa
aa
aa
aa
aa
aa
aa
aa
aa
ab
aB
aB
aB
aB
aB
aB
aB
aB
aB
"}
(2,1,1) = {"
aa
aa
aa
aa
aa
aa
aa
ab
aB
aB
aB
aB
aB
aB
bq
bC
bq
bR
bY
cj
co
cy
cz
"}
(3,1,1) = {"
aa
aa
aa
aa
aa
aa
aa
aB
aL
aR
aR
aR
be
aB
ap
at
bP
bP
bZ
bP
cp
cy
cA
"}
(4,1,1) = {"
aa
aa
aa
aa
aa
aa
aa
aB
bP
bP
bP
bP
bP
bk
bs
at
bI
bS
ca
ck
cq
cy
cB
"}
(5,1,1) = {"
ab
aB
aB
aB
aB
aa
aa
aB
bP
bP
bP
bP
bP
aB
bt
at
bN
bV
cb
bj
aB
aB
MJ
"}
(6,1,1) = {"
aB
ag
an
pO
aB
dp
aa
aB
aN
aS
aU
ap
vv
aB
bu
at
bN
bV
cc
aB
aa
aa
aa
"}
(7,1,1) = {"
ae
ah
ao
at
aB
aB
aB
aB
aB
aB
aB
aW
aQ
bj
aQ
aQ
bl
aQ
aB
aB
aB
aB
aa
"}
(8,1,1) = {"
ae
ai
ap
at
au
ay
aC
aH
aC
aC
aQ
bP
bP
bK
bP
bE
bN
bV
bP
cl
cy
cz
aa
"}
(9,1,1) = {"
ae
aj
aq
at
av
bP
ap
ap
ap
bP
aV
bP
ap
ap
ap
ap
bN
bV
bP
bo
cy
cA
aa
"}
(10,1,1) = {"
ae
ak
ap
at
aB
aA
aE
aI
aE
aE
aQ
bP
bP
bP
bP
cn
bN
bV
bP
cl
cy
cB
aa
"}
(11,1,1) = {"
ae
al
ar
at
aB
aB
aB
aB
aB
aB
aB
ba
aQ
bj
aQ
aQ
bl
aQ
aB
aB
aB
aB
aa
"}
(12,1,1) = {"
aB
am
as
No
aB
MJ
aa
aB
aB
tZ
aX
ap
Xg
aB
bx
at
bN
bV
ce
aB
aa
aa
aa
"}
(13,1,1) = {"
aF
aB
aB
aB
aB
aa
aa
aB
bv
Mw
bP
bP
bP
aB
by
at
bN
bV
cf
bj
aB
aB
dp
"}
(14,1,1) = {"
aa
aa
aa
aa
aa
aa
aa
aB
bw
up
bP
bP
rB
au
bz
at
bO
bW
ca
bP
sI
cy
cz
"}
(15,1,1) = {"
aa
aa
aa
aa
aa
aa
aa
aB
bw
nG
aT
bd
bi
aB
bA
at
bP
bP
ch
bP
ct
cy
cA
"}
(16,1,1) = {"
aa
aa
aa
aa
aa
aa
aa
aF
Eh
aB
aY
aB
aB
aB
bB
at
bQ
bX
ci
cn
sI
cy
cB
"}
(17,1,1) = {"
aa
aa
aa
aa
aa
aa
aa
aa
aa
aa
aa
aa
aa
aF
aB
aB
aB
aB
aB
aB
aB
aB
aB
"}
