//MAP CONVERTED BY dmm2tgm.py THIS HEADER COMMENT PREVENTS RECONVERSION, DO NOT REMOVE
"a" = (
/turf/closed/wall/mineral/titanium,
/area/external/shuttle/station/labor)
"c" = (
/obj/machinery/computer/shuttle/labor{
	dir = 4
	},
/obj/structure/reagent_dispensers/peppertank{
	pixel_x = -31
	},
/obj/effect/turf_decal/bot,
/turf/open/floor/mineral/plastitanium,
/area/external/shuttle/station/labor)
"d" = (
/obj/structure/chair/comfy/shuttle{
	dir = 1
	},
/turf/open/floor/mineral/plastitanium,
/area/external/shuttle/station/labor)
"e" = (
/obj/structure/table,
/obj/item/folder/red,
/obj/item/restraints/handcuffs,
/turf/open/floor/mineral/plastitanium,
/area/external/shuttle/station/labor)
"f" = (
/obj/effect/turf_decal/tile/neutral,
/obj/effect/turf_decal/tile/neutral{
	dir = 1
	},
/obj/effect/turf_decal/stripes/line{
	dir = 9
	},
/obj/effect/turf_decal/stripes/corner,
/turf/open/floor/mineral/plastitanium/red,
/area/external/shuttle/station/labor)
"g" = (
/obj/machinery/button/flasher{
	id = "gulagshuttleflasher";
	name = "Flash Control";
	pixel_y = -26;
	req_access = list("security")
	},
/obj/machinery/light,
/obj/effect/turf_decal/tile/neutral,
/obj/effect/turf_decal/tile/neutral{
	dir = 1
	},
/obj/effect/turf_decal/stripes/line{
	dir = 1
	},
/obj/effect/turf_decal/stripes/line,
/turf/open/floor/mineral/plastitanium/red,
/area/external/shuttle/station/labor)
"h" = (
/obj/machinery/mineral/stacking_unit_console{
	machinedir = 2;
	pixel_x = 30;
	pixel_y = 30
	},
/obj/effect/turf_decal/tile/neutral,
/obj/effect/turf_decal/tile/neutral{
	dir = 1
	},
/obj/effect/turf_decal/stripes/line{
	dir = 1
	},
/obj/effect/turf_decal/stripes/line,
/turf/open/floor/mineral/plastitanium/red,
/area/external/shuttle/station/labor)
"k" = (
/obj/machinery/mineral/stacking_machine/laborstacker{
	input_dir = 2;
	output_dir = 1
	},
/obj/effect/turf_decal/stripes/line{
	dir = 8
	},
/obj/effect/turf_decal/stripes/line{
	dir = 4
	},
/turf/open/floor/mineral/plastitanium,
/area/external/shuttle/station/labor)
"l" = (
/obj/effect/turf_decal/tile/neutral,
/obj/effect/turf_decal/tile/neutral{
	dir = 1
	},
/obj/effect/turf_decal/stripes/line{
	dir = 8
	},
/obj/effect/turf_decal/stripes/corner{
	dir = 4
	},
/turf/open/floor/mineral/plastitanium/red,
/area/external/shuttle/station/labor)
"m" = (
/obj/machinery/light{
	dir = 1
	},
/obj/effect/turf_decal/tile/neutral,
/obj/effect/turf_decal/tile/neutral{
	dir = 1
	},
/obj/effect/turf_decal/stripes/line{
	dir = 1
	},
/turf/open/floor/mineral/plastitanium/red,
/area/external/shuttle/station/labor)
"n" = (
/obj/machinery/mineral/labor_claim_console{
	machinedir = 1;
	pixel_x = 30
	},
/obj/effect/turf_decal/tile/neutral,
/obj/effect/turf_decal/tile/neutral{
	dir = 1
	},
/obj/effect/turf_decal/stripes/line{
	dir = 5
	},
/turf/open/floor/mineral/plastitanium/red,
/area/external/shuttle/station/labor)
"o" = (
/obj/effect/turf_decal/tile/neutral,
/obj/effect/turf_decal/tile/neutral{
	dir = 1
	},
/obj/structure/chair/comfy/shuttle{
	dir = 4
	},
/obj/effect/turf_decal/stripes/line{
	dir = 10
	},
/turf/open/floor/mineral/plastitanium/red,
/area/external/shuttle/station/labor)
"p" = (
/obj/effect/turf_decal/tile/neutral,
/obj/effect/turf_decal/tile/neutral{
	dir = 1
	},
/obj/effect/turf_decal/stripes/line,
/turf/open/floor/mineral/plastitanium/red,
/area/external/shuttle/station/labor)
"q" = (
/obj/machinery/flasher{
	id = "gulagshuttleflasher";
	pixel_x = 25
	},
/obj/effect/turf_decal/tile/neutral,
/obj/effect/turf_decal/tile/neutral{
	dir = 1
	},
/obj/structure/chair/comfy/shuttle{
	dir = 8
	},
/obj/effect/turf_decal/stripes/line{
	dir = 6
	},
/turf/open/floor/mineral/plastitanium/red,
/area/external/shuttle/station/labor)
"r" = (
/obj/effect/turf_decal/tile/brown,
/obj/effect/turf_decal/tile/brown{
	dir = 1
	},
/obj/structure/closet/crate,
/obj/effect/turf_decal/delivery,
/obj/effect/turf_decal/stripes/line,
/turf/open/floor/mineral/titanium/yellow,
/area/external/shuttle/station/labor)
"s" = (
/obj/effect/turf_decal/tile/brown,
/obj/effect/turf_decal/tile/brown{
	dir = 1
	},
/obj/effect/turf_decal/loading_area{
	dir = 4
	},
/obj/effect/turf_decal/stripes/line,
/turf/open/floor/mineral/titanium/yellow,
/area/external/shuttle/station/labor)
"t" = (
/obj/effect/turf_decal/tile/brown,
/obj/effect/turf_decal/tile/brown{
	dir = 1
	},
/obj/effect/turf_decal/stripes/line,
/turf/open/floor/mineral/titanium/yellow,
/area/external/shuttle/station/labor)
"v" = (
/turf/closed/wall/mineral/titanium/nodiagonal,
/area/external/shuttle/station/labor)
"x" = (
/turf/closed/wall/mineral/plastitanium,
/area/external/shuttle/station/labor)
"y" = (
/obj/structure/shuttle/engine/propulsion,
/turf/open/floor/plating/airless,
/area/external/shuttle/station/labor)
"A" = (
/obj/effect/spawner/structure/window/shuttle,
/obj/structure/shuttle/engine/heater,
/obj/machinery/door/firedoor/border_only,
/turf/open/floor/plating,
/area/external/shuttle/station/labor)
"D" = (
/obj/effect/spawner/structure/window/shuttle,
/obj/machinery/door/firedoor/border_only{
	dir = 8
	},
/turf/open/floor/plating,
/area/external/shuttle/station/labor)
"E" = (
/obj/machinery/door/airlock/titanium{
	id_tag = "prisonshuttle";
	name = "Labor Shuttle Airlock"
	},
/obj/docking_port/mobile{
	dir = 8;
	dwidth = 2;
	height = 5;
	shuttle_id = "laborcamp";
	name = "labor camp shuttle";
	port_direction = 4;
	width = 9
	},
/obj/effect/turf_decal/stripes/line{
	dir = 4
	},
/obj/effect/turf_decal/stripes/line{
	dir = 8
	},
/obj/machinery/door/firedoor/border_only{
	dir = 8
	},
/obj/machinery/door/firedoor/border_only{
	dir = 4
	},
/turf/open/floor/mineral/plastitanium,
/area/external/shuttle/station/labor)
"L" = (
/obj/effect/spawner/structure/window/shuttle,
/obj/machinery/door/firedoor/border_only{
	dir = 1
	},
/turf/open/floor/plating,
/area/external/shuttle/station/labor)
"M" = (
/obj/machinery/door/airlock/titanium{
	name = "Labor Shuttle Airlock"
	},
/obj/effect/turf_decal/stripes/line{
	dir = 4
	},
/obj/effect/turf_decal/stripes/line{
	dir = 8
	},
/obj/machinery/door/firedoor/border_only{
	dir = 8
	},
/obj/machinery/door/firedoor/border_only{
	dir = 4
	},
/obj/effect/mapping_helpers/airlock/access/all/security/brig,
/turf/open/floor/mineral/plastitanium,
/area/external/shuttle/station/labor)
"P" = (
/obj/machinery/door/airlock/titanium{
	name = "Labor Shuttle Airlock"
	},
/obj/effect/turf_decal/stripes/line,
/obj/effect/turf_decal/stripes/line{
	dir = 1
	},
/obj/machinery/door/firedoor/border_only{
	dir = 1
	},
/obj/machinery/door/firedoor/border_only,
/obj/effect/mapping_helpers/airlock/access/all/security/brig,
/turf/open/floor/mineral/plastitanium,
/area/external/shuttle/station/labor)

(1,1,1) = {"
a
a
D
a
D
a
D
v
x
"}
(2,1,1) = {"
L
c
f
P
l
o
r
A
y
"}
(3,1,1) = {"
L
d
g
a
m
p
s
A
y
"}
(4,1,1) = {"
L
e
h
k
n
q
t
A
y
"}
(5,1,1) = {"
a
a
M
a
a
a
E
v
x
"}
