//MAP CONVERTED BY dmm2tgm.py THIS HEADER COMMENT PREVENTS RECONVERSION, DO NOT REMOVE
"aa" = (
/obj/machinery/door/poddoor{
	id = "caravansyndicate3_bridge"
	},
/obj/effect/spawner/structure/window/plastitanium,
/obj/machinery/door/firedoor/border_only{
	dir = 1
	},
/turf/open/floor/plating,
/area/external/shuttle/ruins/dropship_syndicate)
"ab" = (
/obj/machinery/door/poddoor{
	id = "caravansyndicate3_bridge"
	},
/obj/effect/spawner/structure/window/plastitanium,
/obj/machinery/door/firedoor/border_only{
	dir = 1
	},
/obj/machinery/door/firedoor/border_only{
	dir = 4
	},
/turf/open/floor/plating,
/area/external/shuttle/ruins/dropship_syndicate)
"ac" = (
/obj/machinery/door/poddoor{
	id = "caravansyndicate3_bridge"
	},
/obj/effect/spawner/structure/window/plastitanium,
/turf/open/floor/plating,
/area/external/shuttle/ruins/dropship_syndicate)
"ad" = (
/obj/machinery/door/poddoor{
	id = "caravansyndicate3_bridge"
	},
/obj/effect/spawner/structure/window/plastitanium,
/obj/machinery/door/firedoor/border_only{
	dir = 4
	},
/turf/open/floor/plating,
/area/external/shuttle/ruins/dropship_syndicate)
"ae" = (
/obj/machinery/firealarm{
	dir = 4;
	pixel_x = -24
	},
/turf/open/floor/plasteel/dark,
/area/external/shuttle/ruins/dropship_syndicate)
"af" = (
/obj/effect/decal/cleanable/dirt,
/obj/machinery/firealarm{
	dir = 4;
	pixel_x = -24
	},
/turf/open/floor/plasteel/dark,
/area/external/shuttle/ruins/dropship_syndicate)
"ag" = (
/obj/machinery/door/poddoor{
	id = "caravansyndicate3_bridge"
	},
/obj/effect/spawner/structure/window/plastitanium,
/obj/machinery/door/firedoor/border_only{
	dir = 4
	},
/obj/machinery/door/firedoor/border_only,
/turf/open/floor/plating,
/area/external/shuttle/ruins/dropship_syndicate)
"ah" = (
/obj/machinery/door/poddoor{
	id = "caravansyndicate3_bridge"
	},
/obj/effect/spawner/structure/window/plastitanium,
/obj/machinery/door/firedoor/border_only,
/turf/open/floor/plating,
/area/external/shuttle/ruins/dropship_syndicate)
"ai" = (
/obj/machinery/door/poddoor{
	id = "caravansyndicate3_bridge"
	},
/obj/effect/spawner/structure/window/plastitanium,
/obj/machinery/door/firedoor/border_only,
/obj/machinery/door/firedoor/border_only{
	dir = 4
	},
/turf/open/floor/plating,
/area/external/shuttle/ruins/dropship_syndicate)
"al" = (
/obj/machinery/airalarm/syndicate{
	dir = 4;
	pixel_x = -24
	},
/obj/effect/decal/cleanable/dirt,
/turf/open/floor/plasteel/dark,
/area/external/shuttle/ruins/dropship_syndicate)
"bB" = (
/obj/machinery/light/small{
	dir = 8
	},
/obj/machinery/button/door{
	id = "caravansyndicate3_bolt_starboard";
	name = "External Bolt Control";
	normaldoorcontrol = 1;
	pixel_x = -24;
	pixel_y = -6;
	req_access = list("syndicate");
	specialfunctions = 4
	},
/turf/open/floor/plasteel/dark,
/area/external/shuttle/ruins/dropship_syndicate)
"bN" = (
/obj/machinery/power/smes/fullycharged,
/obj/effect/turf_decal/stripes/line{
	dir = 5
	},
/obj/structure/cable/yellow{
	icon_state = "0-4"
	},
/obj/effect/decal/cleanable/dirt,
/obj/effect/decal/cleanable/dirt,
/turf/open/floor/plating,
/area/external/shuttle/ruins/dropship_syndicate)
"cB" = (
/obj/effect/turf_decal/tile/neutral{
	dir = 1
	},
/obj/effect/turf_decal/tile/neutral,
/obj/effect/turf_decal/tile/neutral{
	dir = 4
	},
/obj/effect/turf_decal/tile/neutral{
	dir = 8
	},
/turf/open/floor/plasteel/dark,
/area/external/shuttle/ruins/dropship_syndicate)
"dZ" = (
/obj/structure/shuttle/engine/propulsion/burst{
	dir = 8
	},
/turf/open/floor/plating/airless,
/area/external/shuttle/ruins/dropship_syndicate)
"gl" = (
/obj/machinery/door/airlock/hatch{
	id_tag = "caravansyndicate3_bolt_port";
	name = "External Airlock";
	normalspeed = 0
	},
/obj/docking_port/mobile{
	dir = 2;
	dwidth = 6;
	height = 7;
	shuttle_id = "caravansyndicate3";
	name = "Syndicate Drop Ship";
	port_direction = 8;
	preferred_direction = 4;
	width = 15
	},
/obj/effect/mapping_helpers/airlock/cyclelink_helper,
/obj/machinery/door/firedoor/border_only{
	dir = 1
	},
/obj/machinery/door/firedoor/border_only,
/obj/effect/mapping_helpers/airlock/access/all/syndicate/general,
/turf/open/floor/plating,
/area/external/shuttle/ruins/dropship_syndicate)
"ha" = (
/obj/effect/turf_decal/stripes/line{
	dir = 6
	},
/obj/structure/cable,
/obj/machinery/power/port_gen/pacman{
	anchored = 1
	},
/obj/item/wrench,
/obj/effect/decal/cleanable/dirt,
/turf/open/floor/plating,
/area/external/shuttle/ruins/dropship_syndicate)
"hF" = (
/obj/structure/chair/comfy/shuttle,
/obj/machinery/light/small{
	dir = 8
	},
/obj/structure/cable/yellow{
	icon_state = "0-2"
	},
/obj/machinery/power/apc/syndicate{
	dir = 8;
	name = "Syndicate Drop Ship APC";
	pixel_x = -25
	},
/obj/effect/decal/cleanable/dirt,
/turf/open/floor/pod/dark,
/area/external/shuttle/ruins/dropship_syndicate)
"ka" = (
/obj/structure/chair/comfy/shuttle{
	dir = 1
	},
/obj/machinery/light/small{
	dir = 8
	},
/obj/effect/decal/cleanable/dirt,
/turf/open/floor/pod/dark,
/area/external/shuttle/ruins/dropship_syndicate)
"mJ" = (
/obj/structure/shuttle/engine/propulsion/burst/left{
	dir = 8
	},
/turf/open/floor/plating/airless,
/area/external/shuttle/ruins/dropship_syndicate)
"ns" = (
/obj/structure/table/reinforced,
/obj/machinery/button/door{
	id = "caravansyndicate3_bridge";
	name = "Bridge Blast Door Control";
	pixel_x = -16;
	pixel_y = 5;
	req_access = list("syndicate")
	},
/obj/machinery/button/door{
	id = "caravansyndicate3_bolt_bridge";
	name = "Bridge Bolt Control";
	normaldoorcontrol = 1;
	pixel_x = -16;
	pixel_y = -5;
	req_access = list("syndicate");
	specialfunctions = 4
	},
/obj/effect/decal/cleanable/dirt,
/obj/effect/turf_decal/tile/red,
/obj/effect/turf_decal/tile/red{
	dir = 4
	},
/obj/effect/turf_decal/tile/red{
	dir = 8
	},
/turf/open/floor/plasteel/dark,
/area/external/shuttle/ruins/dropship_syndicate)
"qE" = (
/obj/effect/turf_decal/stripes/line{
	dir = 9
	},
/obj/effect/decal/cleanable/dirt,
/obj/structure/closet/syndicate{
	anchored = 1
	},
/obj/item/clothing/under/syndicate,
/obj/item/clothing/shoes/sneakers/black,
/turf/open/floor/mineral/plastitanium,
/area/external/shuttle/ruins/dropship_syndicate)
"rz" = (
/obj/machinery/computer/shuttle/caravan/syndicate3{
	dir = 8
	},
/obj/effect/turf_decal/tile/red{
	dir = 1
	},
/obj/effect/turf_decal/tile/red{
	dir = 8
	},
/turf/open/floor/plasteel/dark,
/area/external/shuttle/ruins/dropship_syndicate)
"rV" = (
/obj/structure/chair/comfy/shuttle{
	dir = 1
	},
/obj/effect/decal/cleanable/dirt,
/turf/open/floor/pod/dark,
/area/external/shuttle/ruins/dropship_syndicate)
"sb" = (
/obj/effect/decal/cleanable/dirt,
/obj/machinery/computer/camera_advanced/shuttle_docker/caravan/syndicate3{
	dir = 8
	},
/obj/effect/turf_decal/tile/red{
	dir = 1
	},
/obj/effect/turf_decal/tile/red,
/obj/effect/turf_decal/tile/red{
	dir = 8
	},
/turf/open/floor/plasteel/dark,
/area/external/shuttle/ruins/dropship_syndicate)
"sn" = (
/obj/structure/chair/comfy/shuttle,
/obj/effect/decal/cleanable/dirt,
/turf/open/floor/pod/dark,
/area/external/shuttle/ruins/dropship_syndicate)
"ss" = (
/obj/effect/turf_decal/tile/red{
	dir = 1
	},
/obj/effect/turf_decal/tile/red{
	dir = 4
	},
/turf/open/floor/plasteel/dark,
/area/external/shuttle/ruins/dropship_syndicate)
"uy" = (
/obj/structure/table/reinforced,
/obj/machinery/recharger,
/obj/machinery/light/small{
	dir = 8
	},
/obj/effect/turf_decal/tile/red{
	dir = 1
	},
/obj/effect/turf_decal/tile/red,
/obj/effect/turf_decal/tile/red{
	dir = 8
	},
/turf/open/floor/plasteel/dark,
/area/external/shuttle/ruins/dropship_syndicate)
"vw" = (
/obj/structure/table/reinforced,
/obj/item/storage/firstaid/regular,
/obj/item/assembly/flash/handheld,
/obj/effect/decal/cleanable/dirt,
/obj/effect/turf_decal/tile/red{
	dir = 1
	},
/obj/effect/turf_decal/tile/red,
/obj/effect/turf_decal/tile/red{
	dir = 4
	},
/turf/open/floor/plasteel/dark,
/area/external/shuttle/ruins/dropship_syndicate)
"vQ" = (
/obj/structure/shuttle/engine/propulsion/burst/right{
	dir = 8
	},
/turf/open/floor/plating/airless,
/area/external/shuttle/ruins/dropship_syndicate)
"wH" = (
/obj/structure/shuttle/engine/heater{
	dir = 8
	},
/obj/structure/window/reinforced{
	dir = 4
	},
/turf/open/floor/plating/airless,
/area/external/shuttle/ruins/dropship_syndicate)
"xC" = (
/obj/machinery/light/small{
	dir = 8
	},
/obj/machinery/button/door{
	id = "caravansyndicate3_bolt_port";
	name = "External Bolt Control";
	normaldoorcontrol = 1;
	pixel_x = -24;
	pixel_y = 6;
	req_access = list("syndicate");
	specialfunctions = 4
	},
/turf/open/floor/plasteel/dark,
/area/external/shuttle/ruins/dropship_syndicate)
"BQ" = (
/obj/effect/turf_decal/tile/red,
/obj/effect/turf_decal/tile/red{
	dir = 8
	},
/turf/open/floor/plasteel/dark,
/area/external/shuttle/ruins/dropship_syndicate)
"Cm" = (
/obj/structure/chair/comfy/shuttle{
	dir = 1
	},
/obj/machinery/firealarm{
	dir = 1;
	pixel_y = -26
	},
/obj/effect/decal/cleanable/dirt,
/turf/open/floor/pod/dark,
/area/external/shuttle/ruins/dropship_syndicate)
"Dt" = (
/obj/effect/turf_decal/stripes/line{
	dir = 8
	},
/obj/machinery/light/small{
	dir = 4
	},
/obj/effect/decal/cleanable/dirt,
/obj/effect/decal/cleanable/dirt,
/obj/structure/closet/syndicate{
	anchored = 1
	},
/obj/item/gun/ballistic/automatic/pistol,
/obj/item/crowbar/red,
/turf/open/floor/mineral/plastitanium,
/area/external/shuttle/ruins/dropship_syndicate)
"Dx" = (
/obj/effect/decal/cleanable/dirt,
/obj/effect/turf_decal/tile/neutral{
	dir = 1
	},
/obj/effect/turf_decal/tile/neutral,
/obj/effect/turf_decal/tile/neutral{
	dir = 4
	},
/obj/effect/turf_decal/tile/neutral{
	dir = 8
	},
/turf/open/floor/plasteel/dark,
/area/external/shuttle/ruins/dropship_syndicate)
"EO" = (
/obj/structure/chair/comfy/shuttle,
/obj/machinery/airalarm/syndicate{
	pixel_y = 24
	},
/obj/effect/decal/cleanable/dirt,
/turf/open/floor/pod/dark,
/area/external/shuttle/ruins/dropship_syndicate)
"Fa" = (
/obj/effect/turf_decal/stripes/line{
	dir = 10
	},
/obj/effect/decal/cleanable/dirt,
/obj/structure/closet/syndicate{
	anchored = 1
	},
/obj/item/clothing/under/syndicate/combat,
/obj/item/clothing/shoes/jackboots,
/obj/item/storage/belt/military,
/obj/item/crowbar/red,
/turf/open/floor/mineral/plastitanium,
/area/external/shuttle/ruins/dropship_syndicate)
"Gx" = (
/obj/machinery/airalarm/syndicate{
	dir = 4;
	pixel_x = -24
	},
/turf/open/floor/plasteel/dark,
/area/external/shuttle/ruins/dropship_syndicate)
"HJ" = (
/obj/effect/turf_decal/stripes/line{
	dir = 8
	},
/obj/structure/sign/warning/vacuum{
	pixel_y = -32
	},
/obj/effect/decal/cleanable/dirt,
/obj/structure/closet/syndicate{
	anchored = 1
	},
/obj/item/clothing/under/syndicate/combat,
/obj/item/storage/belt/military,
/turf/open/floor/mineral/plastitanium,
/area/external/shuttle/ruins/dropship_syndicate)
"HM" = (
/obj/structure/chair/comfy/shuttle{
	dir = 4
	},
/mob/living/simple_animal/hostile/syndicate/ranged/smg/pilot{
	environment_smash = 0
	},
/turf/open/floor/plasteel/dark,
/area/external/shuttle/ruins/dropship_syndicate)
"Ij" = (
/obj/machinery/turretid/syndicate{
	ailock = 1;
	control_area = null;
	desc = "A specially designed set of turret controls. Looks to be covered in protective casing to prevent AI interfacing.";
	lethal = 1;
	name = "Shuttle turret control";
	pixel_y = 34;
	req_access = list("syndicate")
	},
/obj/structure/chair/comfy/shuttle{
	dir = 4
	},
/obj/effect/turf_decal/tile/red{
	dir = 4
	},
/turf/open/floor/plasteel/dark,
/area/external/shuttle/ruins/dropship_syndicate)
"IR" = (
/obj/effect/mapping_helpers/airlock/locked,
/obj/machinery/door/airlock/hatch{
	id_tag = "caravansyndicate3_bolt_bridge";
	name = "Bridge"
	},
/obj/effect/mapping_helpers/airlock/cyclelink_helper{
	dir = 8
	},
/obj/effect/turf_decal/tile/neutral{
	dir = 1
	},
/obj/effect/turf_decal/tile/neutral,
/obj/effect/turf_decal/tile/neutral{
	dir = 4
	},
/obj/effect/turf_decal/tile/neutral{
	dir = 8
	},
/obj/machinery/door/firedoor/border_only{
	dir = 4
	},
/obj/machinery/door/firedoor/border_only{
	dir = 8
	},
/obj/effect/mapping_helpers/airlock/access/all/syndicate/general,
/turf/open/floor/plasteel/dark,
/area/external/shuttle/ruins/dropship_syndicate)
"Jv" = (
/turf/template_noop,
/area/template_noop)
"KS" = (
/obj/machinery/door/airlock/hatch{
	id_tag = "caravansyndicate3_bolt_starboard";
	name = "External Airlock";
	normalspeed = 0
	},
/obj/effect/mapping_helpers/airlock/cyclelink_helper{
	dir = 1
	},
/obj/machinery/door/firedoor/border_only{
	dir = 1
	},
/obj/machinery/door/firedoor/border_only,
/obj/effect/mapping_helpers/airlock/access/all/syndicate/general,
/turf/open/floor/plating,
/area/external/shuttle/ruins/dropship_syndicate)
"Lq" = (
/obj/effect/turf_decal/stripes/line{
	dir = 8
	},
/obj/structure/closet/syndicate{
	anchored = 1
	},
/obj/structure/sign/warning/vacuum{
	pixel_y = 32
	},
/obj/effect/decal/cleanable/dirt,
/obj/item/clothing/shoes/sneakers/black,
/turf/open/floor/mineral/plastitanium,
/area/external/shuttle/ruins/dropship_syndicate)
"NH" = (
/obj/effect/turf_decal/stripes/line{
	dir = 8
	},
/obj/machinery/light/small{
	dir = 4
	},
/obj/structure/closet/syndicate{
	anchored = 1
	},
/obj/item/clothing/under/syndicate,
/obj/item/clothing/glasses/night,
/turf/open/floor/mineral/plastitanium,
/area/external/shuttle/ruins/dropship_syndicate)
"Pt" = (
/obj/effect/turf_decal/stripes/line{
	dir = 4
	},
/obj/structure/closet/crate,
/obj/machinery/power/terminal{
	dir = 1
	},
/obj/structure/cable{
	icon_state = "0-2"
	},
/obj/item/stack/sheet/metal/twenty,
/obj/item/stack/sheet/glass{
	amount = 10
	},
/obj/item/stack/sheet/mineral/plastitanium{
	amount = 20
	},
/obj/item/storage/box/lights/bulbs,
/obj/item/storage/toolbox/mechanical,
/obj/item/stack/sheet/mineral/plasma{
	amount = 20
	},
/turf/open/floor/plating,
/area/external/shuttle/ruins/dropship_syndicate)
"PL" = (
/obj/machinery/porta_turret/syndicate/energy{
	dir = 2;
	icon_state = "standard_lethal";
	mode = 1
	},
/turf/closed/wall/mineral/plastitanium/nodiagonal,
/area/external/shuttle/ruins/dropship_syndicate)
"Rj" = (
/obj/machinery/porta_turret/syndicate/energy{
	dir = 1;
	icon_state = "standard_lethal";
	mode = 1
	},
/turf/closed/wall/mineral/plastitanium/nodiagonal,
/area/external/shuttle/ruins/dropship_syndicate)
"Sl" = (
/obj/structure/table/reinforced,
/obj/item/storage/toolbox/emergency,
/obj/item/wrench,
/obj/machinery/light/small{
	dir = 8
	},
/obj/effect/decal/cleanable/dirt,
/obj/effect/decal/cleanable/dirt,
/obj/effect/turf_decal/tile/red{
	dir = 1
	},
/obj/effect/turf_decal/tile/red{
	dir = 4
	},
/obj/effect/turf_decal/tile/red{
	dir = 8
	},
/turf/open/floor/plasteel/dark,
/area/external/shuttle/ruins/dropship_syndicate)
"Tn" = (
/turf/closed/wall/mineral/plastitanium/nodiagonal,
/area/external/shuttle/ruins/dropship_syndicate)
"UD" = (
/obj/effect/decal/cleanable/dirt,
/obj/effect/turf_decal/tile/red,
/obj/effect/turf_decal/tile/red{
	dir = 8
	},
/turf/open/floor/plasteel/dark,
/area/external/shuttle/ruins/dropship_syndicate)
"US" = (
/obj/structure/cable/yellow{
	icon_state = "1-8"
	},
/obj/effect/decal/cleanable/dirt,
/obj/effect/turf_decal/tile/red{
	dir = 1
	},
/obj/effect/turf_decal/tile/red{
	dir = 4
	},
/turf/open/floor/plasteel/dark,
/area/external/shuttle/ruins/dropship_syndicate)
"Vf" = (
/obj/machinery/door/airlock/hatch{
	name = "Ready Room"
	},
/obj/effect/mapping_helpers/airlock/cyclelink_helper{
	dir = 4
	},
/obj/effect/turf_decal/tile/neutral{
	dir = 1
	},
/obj/effect/turf_decal/tile/neutral,
/obj/effect/turf_decal/tile/neutral{
	dir = 4
	},
/obj/effect/turf_decal/tile/neutral{
	dir = 8
	},
/obj/machinery/door/firedoor/border_only{
	dir = 4
	},
/obj/machinery/door/firedoor/border_only{
	dir = 8
	},
/obj/effect/mapping_helpers/airlock/access/all/syndicate/general,
/turf/open/floor/plasteel/dark,
/area/external/shuttle/ruins/dropship_syndicate)
"Wr" = (
/obj/structure/chair/comfy/shuttle{
	dir = 4
	},
/obj/effect/turf_decal/tile/red,
/turf/open/floor/plasteel/dark,
/area/external/shuttle/ruins/dropship_syndicate)
"YU" = (
/obj/effect/turf_decal/stripes/line{
	dir = 10
	},
/obj/structure/closet/syndicate{
	anchored = 1
	},
/obj/item/clothing/under/syndicate/combat,
/turf/open/floor/mineral/plastitanium,
/area/external/shuttle/ruins/dropship_syndicate)
"ZB" = (
/turf/closed/wall/mineral/plastitanium,
/area/external/shuttle/ruins/dropship_syndicate)
"ZI" = (
/obj/effect/turf_decal/stripes/line{
	dir = 9
	},
/obj/effect/decal/cleanable/dirt,
/obj/structure/closet/syndicate{
	anchored = 1
	},
/obj/item/clothing/shoes/jackboots,
/obj/item/crowbar/red,
/turf/open/floor/mineral/plastitanium,
/area/external/shuttle/ruins/dropship_syndicate)
"ZJ" = (
/turf/open/floor/plasteel/dark,
/area/external/shuttle/ruins/dropship_syndicate)
"ZK" = (
/obj/machinery/computer/crew{
	dir = 8
	},
/obj/effect/decal/cleanable/dirt,
/obj/effect/turf_decal/tile/red{
	dir = 1
	},
/obj/effect/turf_decal/tile/red{
	dir = 4
	},
/obj/effect/turf_decal/tile/red{
	dir = 8
	},
/turf/open/floor/plasteel/dark,
/area/external/shuttle/ruins/dropship_syndicate)

(1,1,1) = {"
Jv
mJ
dZ
dZ
dZ
vQ
Jv
"}
(2,1,1) = {"
ZB
wH
wH
wH
wH
wH
ZB
"}
(3,1,1) = {"
Tn
Tn
bN
Pt
ha
Tn
Tn
"}
(4,1,1) = {"
Tn
hF
US
ZJ
BQ
ka
Tn
"}
(5,1,1) = {"
Tn
EO
ss
cB
BQ
Cm
Tn
"}
(6,1,1) = {"
Tn
sn
ss
cB
UD
rV
Tn
"}
(7,1,1) = {"
Tn
NH
Fa
cB
qE
Dt
Tn
"}
(8,1,1) = {"
Rj
Tn
Tn
Vf
Tn
Tn
PL
"}
(9,1,1) = {"
gl
xC
al
cB
ae
bB
KS
"}
(10,1,1) = {"
Tn
Lq
YU
Dx
ZI
HJ
Tn
"}
(11,1,1) = {"
Tn
Tn
Tn
IR
Tn
Tn
Tn
"}
(12,1,1) = {"
Tn
uy
Gx
cB
af
Sl
Tn
"}
(13,1,1) = {"
aa
ns
Ij
HM
Wr
vw
ah
"}
(14,1,1) = {"
ab
ac
sb
rz
ZK
ac
ai
"}
(15,1,1) = {"
Jv
ab
ad
ad
ad
ag
Jv
"}
