//MAP CONVERTED BY dmm2tgm.py THIS HEADER COMMENT PREVENTS RECONVERSION, DO NOT REMOVE
"aa" = (
/obj/machinery/door/poddoor{
	id = "caravanpirate_bridge"
	},
/obj/effect/spawner/structure/window/plastitanium,
/obj/machinery/door/firedoor/border_only{
	dir = 1
	},
/turf/open/floor/plating,
/area/external/shuttle/ruins/pirate_cutter)
"ab" = (
/obj/machinery/atmospherics/pipe/simple/supply/hidden{
	dir = 4
	},
/obj/machinery/door/airlock/engineering{
	name = "Engineering"
	},
/obj/machinery/door/firedoor/border_only{
	dir = 4
	},
/obj/machinery/door/firedoor/border_only{
	dir = 8
	},
/turf/open/floor/plating,
/area/external/shuttle/ruins/pirate_cutter)
"ac" = (
/obj/machinery/atmospherics/pipe/simple/supply/hidden{
	dir = 4
	},
/obj/machinery/door/airlock/medical/glass{
	name = "Medbay"
	},
/obj/effect/decal/cleanable/dirt,
/obj/machinery/door/firedoor/border_only{
	dir = 4
	},
/obj/machinery/door/firedoor/border_only{
	dir = 8
	},
/turf/open/floor/plasteel,
/area/external/shuttle/ruins/pirate_cutter)
"ad" = (
/obj/machinery/door/poddoor{
	id = "caravanpirate_bridge"
	},
/obj/effect/spawner/structure/window/plastitanium,
/obj/machinery/door/firedoor/border_only{
	dir = 1
	},
/obj/machinery/door/firedoor/border_only{
	dir = 4
	},
/turf/open/floor/plating,
/area/external/shuttle/ruins/pirate_cutter)
"ae" = (
/obj/structure/bed,
/obj/item/bedsheet/brown,
/obj/machinery/firealarm{
	dir = 4;
	pixel_x = -24
	},
/turf/open/floor/plasteel/dark/side{
	dir = 6
	},
/area/external/shuttle/ruins/pirate_cutter)
"af" = (
/turf/closed/wall/mineral/plastitanium/nodiagonal,
/area/external/shuttle/ruins/pirate_cutter)
"ag" = (
/obj/machinery/door/poddoor{
	id = "caravanpirate_bridge"
	},
/obj/effect/spawner/structure/window/plastitanium,
/turf/open/floor/plating,
/area/external/shuttle/ruins/pirate_cutter)
"ai" = (
/obj/machinery/door/poddoor{
	id = "caravanpirate_bridge"
	},
/obj/effect/spawner/structure/window/plastitanium,
/obj/machinery/door/firedoor/border_only{
	dir = 4
	},
/turf/open/floor/plating,
/area/external/shuttle/ruins/pirate_cutter)
"aj" = (
/obj/machinery/atmospherics/pipe/simple/supply/hidden{
	dir = 4
	},
/obj/machinery/door/airlock/command{
	name = "Bridge"
	},
/obj/effect/turf_decal/tile/neutral{
	dir = 1
	},
/obj/effect/turf_decal/tile/neutral,
/obj/effect/turf_decal/tile/neutral{
	dir = 4
	},
/obj/effect/turf_decal/tile/neutral{
	dir = 8
	},
/obj/machinery/door/firedoor/border_only{
	dir = 4
	},
/obj/machinery/door/firedoor/border_only{
	dir = 8
	},
/turf/open/floor/plasteel/dark,
/area/external/shuttle/ruins/pirate_cutter)
"ak" = (
/obj/machinery/door/poddoor{
	id = "caravanpirate_bridge"
	},
/obj/effect/spawner/structure/window/plastitanium,
/obj/machinery/door/firedoor/border_only{
	dir = 4
	},
/obj/machinery/door/firedoor/border_only,
/turf/open/floor/plating,
/area/external/shuttle/ruins/pirate_cutter)
"al" = (
/obj/effect/decal/cleanable/dirt,
/mob/living/simple_animal/hostile/pirate/ranged{
	environment_smash = 0
	},
/turf/open/floor/plasteel,
/area/external/shuttle/ruins/pirate_cutter)
"am" = (
/obj/machinery/atmospherics/pipe/simple/supply/hidden{
	dir = 4
	},
/obj/machinery/door/airlock/security{
	name = "Armory"
	},
/obj/effect/decal/cleanable/dirt,
/obj/machinery/door/firedoor/border_only{
	dir = 4
	},
/obj/machinery/door/firedoor/border_only{
	dir = 8
	},
/turf/open/floor/plasteel,
/area/external/shuttle/ruins/pirate_cutter)
"an" = (
/obj/structure/rack,
/obj/item/storage/bag/money/vault,
/obj/effect/turf_decal/tile/blue{
	dir = 4
	},
/mob/living/simple_animal/parrot{
	faction = list("pirate");
	name = "Pegwing"
	},
/turf/open/floor/plasteel/dark,
/area/external/shuttle/ruins/pirate_cutter)
"ao" = (
/obj/machinery/door/poddoor{
	id = "caravanpirate_bridge"
	},
/obj/effect/spawner/structure/window/plastitanium,
/obj/machinery/door/firedoor/border_only,
/turf/open/floor/plating,
/area/external/shuttle/ruins/pirate_cutter)
"aE" = (
/obj/structure/closet{
	name = "pirate outfits"
	},
/obj/item/clothing/head/collectable/pirate,
/obj/item/clothing/suit/pirate,
/obj/item/clothing/under/costume/pirate,
/obj/item/clothing/shoes/jackboots,
/obj/item/clothing/head/pirate/bandana,
/turf/open/floor/plasteel/dark/side{
	dir = 5
	},
/area/external/shuttle/ruins/pirate_cutter)
"bH" = (
/obj/machinery/atmospherics/pipe/simple/supply/hidden{
	dir = 5
	},
/obj/effect/decal/cleanable/dirt,
/turf/open/floor/plasteel,
/area/external/shuttle/ruins/pirate_cutter)
"de" = (
/obj/machinery/atmospherics/pipe/manifold/supply/hidden{
	dir = 8
	},
/obj/effect/turf_decal/tile/neutral{
	dir = 1
	},
/obj/effect/turf_decal/tile/neutral,
/obj/effect/turf_decal/tile/neutral{
	dir = 4
	},
/obj/effect/turf_decal/tile/neutral{
	dir = 8
	},
/turf/open/floor/plasteel/dark,
/area/external/shuttle/ruins/pirate_cutter)
"dE" = (
/obj/effect/turf_decal/tile/neutral{
	dir = 1
	},
/obj/effect/turf_decal/tile/neutral,
/obj/effect/turf_decal/tile/neutral{
	dir = 4
	},
/obj/effect/turf_decal/tile/neutral{
	dir = 8
	},
/turf/open/floor/plasteel/dark,
/area/external/shuttle/ruins/pirate_cutter)
"eL" = (
/obj/machinery/porta_turret/syndicate/pod{
	dir = 10;
	faction = list("pirate")
	},
/turf/closed/wall/mineral/plastitanium,
/area/external/shuttle/ruins/pirate_cutter)
"fh" = (
/obj/machinery/atmospherics/pipe/manifold/supply/hidden{
	dir = 4
	},
/turf/open/floor/plating,
/area/external/shuttle/ruins/pirate_cutter)
"fL" = (
/obj/machinery/computer/shuttle/caravan/pirate{
	dir = 8
	},
/obj/effect/turf_decal/tile/red{
	dir = 1
	},
/obj/effect/turf_decal/tile/red{
	dir = 8
	},
/turf/open/floor/plasteel/dark,
/area/external/shuttle/ruins/pirate_cutter)
"fS" = (
/obj/structure/bed,
/obj/item/bedsheet/brown,
/obj/machinery/airalarm/all_access{
	dir = 4;
	pixel_x = -24
	},
/obj/effect/turf_decal/tile/red{
	dir = 8
	},
/turf/open/floor/plasteel/dark,
/area/external/shuttle/ruins/pirate_cutter)
"fU" = (
/obj/machinery/atmospherics/pipe/manifold/supply/hidden,
/obj/effect/turf_decal/tile/red,
/obj/effect/turf_decal/tile/red{
	dir = 8
	},
/turf/open/floor/plasteel,
/area/external/shuttle/ruins/pirate_cutter)
"gy" = (
/obj/structure/chair/office/dark{
	dir = 4
	},
/obj/machinery/turretid{
	icon_state = "control_kill";
	lethal = 1;
	locked = 0;
	pixel_x = 1;
	pixel_y = -25;
	req_access = null
	},
/obj/effect/turf_decal/tile/neutral{
	dir = 1
	},
/obj/effect/turf_decal/tile/neutral,
/obj/effect/turf_decal/tile/neutral{
	dir = 4
	},
/obj/effect/turf_decal/tile/neutral{
	dir = 8
	},
/mob/living/simple_animal/hostile/pirate/ranged{
	environment_smash = 0
	},
/turf/open/floor/plasteel/dark,
/area/external/shuttle/ruins/pirate_cutter)
"hI" = (
/obj/structure/cable/yellow{
	icon_state = "1-8"
	},
/obj/machinery/atmospherics/pipe/simple/supply/hidden,
/turf/open/floor/plating,
/area/external/shuttle/ruins/pirate_cutter)
"hT" = (
/obj/machinery/light/small{
	dir = 1
	},
/obj/structure/bed,
/obj/item/bedsheet/brown,
/turf/open/floor/plasteel/dark,
/area/external/shuttle/ruins/pirate_cutter)
"hZ" = (
/obj/machinery/atmospherics/pipe/simple/supply/hidden,
/obj/effect/turf_decal/tile/neutral{
	dir = 1
	},
/obj/effect/turf_decal/tile/neutral,
/obj/effect/turf_decal/tile/neutral{
	dir = 4
	},
/obj/effect/turf_decal/tile/neutral{
	dir = 8
	},
/turf/open/floor/plasteel/dark,
/area/external/shuttle/ruins/pirate_cutter)
"iF" = (
/obj/machinery/atmospherics/pipe/simple/supply/hidden{
	dir = 9
	},
/obj/effect/turf_decal/tile/neutral{
	dir = 1
	},
/obj/effect/turf_decal/tile/neutral,
/obj/effect/turf_decal/tile/neutral{
	dir = 4
	},
/obj/effect/turf_decal/tile/neutral{
	dir = 8
	},
/turf/open/floor/plasteel/dark,
/area/external/shuttle/ruins/pirate_cutter)
"iX" = (
/obj/structure/table,
/obj/machinery/door/window/southleft{
	base_state = "right";
	icon_state = "right";
	name = "Weapon Storage"
	},
/obj/item/gun/energy/laser,
/obj/effect/turf_decal/tile/neutral{
	dir = 1
	},
/obj/effect/turf_decal/tile/neutral,
/obj/effect/turf_decal/tile/neutral{
	dir = 4
	},
/obj/effect/turf_decal/tile/neutral{
	dir = 8
	},
/turf/open/floor/plasteel/dark,
/area/external/shuttle/ruins/pirate_cutter)
"jh" = (
/obj/structure/cable,
/obj/machinery/power/port_gen/pacman{
	anchored = 1
	},
/obj/item/wrench,
/obj/effect/turf_decal/stripes/line{
	dir = 6
	},
/turf/open/floor/plating,
/area/external/shuttle/ruins/pirate_cutter)
"jU" = (
/obj/structure/shuttle/engine/propulsion/burst{
	dir = 8
	},
/turf/open/floor/plating/airless,
/area/external/shuttle/ruins/pirate_cutter)
"kl" = (
/obj/machinery/atmospherics/pipe/manifold/supply/hidden{
	dir = 1
	},
/turf/open/floor/plasteel/white/side{
	dir = 1
	},
/area/external/shuttle/ruins/pirate_cutter)
"kY" = (
/obj/machinery/atmospherics/pipe/manifold/supply/hidden{
	dir = 8
	},
/obj/machinery/meter,
/turf/open/floor/plating,
/area/external/shuttle/ruins/pirate_cutter)
"le" = (
/obj/machinery/porta_turret/syndicate/pod{
	dir = 5;
	faction = list("pirate")
	},
/turf/closed/wall/mineral/plastitanium,
/area/external/shuttle/ruins/pirate_cutter)
"lG" = (
/obj/machinery/atmospherics/components/unary/vent_pump/on,
/obj/effect/turf_decal/tile/neutral{
	dir = 1
	},
/obj/effect/turf_decal/tile/neutral,
/obj/effect/turf_decal/tile/neutral{
	dir = 4
	},
/obj/effect/turf_decal/tile/neutral{
	dir = 8
	},
/turf/open/floor/plasteel/dark,
/area/external/shuttle/ruins/pirate_cutter)
"mI" = (
/obj/structure/table,
/obj/item/storage/firstaid/brute{
	pixel_x = 3;
	pixel_y = 3
	},
/obj/item/storage/firstaid/fire,
/obj/machinery/firealarm{
	dir = 1;
	pixel_y = -24
	},
/turf/open/floor/plasteel/white,
/area/external/shuttle/ruins/pirate_cutter)
"na" = (
/obj/machinery/atmospherics/pipe/simple/supply/hidden{
	dir = 4
	},
/turf/open/floor/plasteel/white/side{
	dir = 1
	},
/area/external/shuttle/ruins/pirate_cutter)
"nD" = (
/obj/machinery/light/small{
	dir = 4
	},
/obj/machinery/atmospherics/pipe/simple/supply/hidden{
	dir = 10
	},
/turf/open/floor/plasteel/white/side{
	dir = 1
	},
/area/external/shuttle/ruins/pirate_cutter)
"oe" = (
/obj/structure/table,
/obj/item/circular_saw,
/obj/item/scalpel{
	pixel_y = 12
	},
/obj/item/cautery{
	pixel_x = 4
	},
/obj/machinery/light/small{
	dir = 8
	},
/turf/open/floor/plasteel/white/side{
	dir = 8
	},
/area/external/shuttle/ruins/pirate_cutter)
"oF" = (
/obj/structure/closet{
	name = "pirate outfits"
	},
/obj/item/clothing/head/collectable/pirate,
/obj/item/clothing/suit/pirate,
/obj/item/clothing/under/costume/pirate,
/obj/item/clothing/shoes/jackboots,
/obj/item/clothing/head/pirate/bandana,
/obj/effect/turf_decal/tile/red{
	dir = 1
	},
/turf/open/floor/plasteel/dark,
/area/external/shuttle/ruins/pirate_cutter)
"oL" = (
/turf/closed/wall/mineral/plastitanium,
/area/external/shuttle/ruins/pirate_cutter)
"oO" = (
/obj/machinery/computer/camera_advanced/shuttle_docker/caravan/pirate,
/obj/effect/turf_decal/tile/red{
	dir = 1
	},
/obj/effect/turf_decal/tile/red{
	dir = 4
	},
/turf/open/floor/plasteel/dark,
/area/external/shuttle/ruins/pirate_cutter)
"oT" = (
/obj/structure/table,
/obj/structure/window/reinforced{
	dir = 8
	},
/obj/machinery/door/window/southleft{
	name = "Weapon Storage"
	},
/obj/item/grenade/smokebomb{
	pixel_x = -4
	},
/obj/item/grenade/smokebomb{
	pixel_x = 2
	},
/obj/effect/turf_decal/tile/neutral{
	dir = 1
	},
/obj/effect/turf_decal/tile/neutral,
/obj/effect/turf_decal/tile/neutral{
	dir = 4
	},
/obj/effect/turf_decal/tile/neutral{
	dir = 8
	},
/turf/open/floor/plasteel/dark,
/area/external/shuttle/ruins/pirate_cutter)
"pK" = (
/obj/item/stack/sheet/mineral/gold{
	amount = 25
	},
/obj/item/stack/sheet/mineral/bananium{
	amount = 5
	},
/obj/item/stack/sheet/mineral/silver{
	amount = 25
	},
/obj/item/stack/sheet/mineral/uranium{
	amount = 10
	},
/obj/item/stack/sheet/mineral/diamond{
	amount = 5
	},
/obj/structure/closet/crate,
/obj/item/coin/silver,
/obj/item/coin/silver,
/obj/item/coin/silver,
/obj/item/coin/gold,
/obj/item/coin/gold,
/obj/effect/turf_decal/tile/blue,
/turf/open/floor/plasteel/dark,
/area/external/shuttle/ruins/pirate_cutter)
"pS" = (
/obj/machinery/atmospherics/components/unary/vent_pump/on,
/obj/effect/decal/cleanable/dirt,
/turf/open/floor/plasteel,
/area/external/shuttle/ruins/pirate_cutter)
"pZ" = (
/obj/structure/tank_dispenser/oxygen,
/obj/machinery/firealarm{
	dir = 2;
	pixel_y = 24
	},
/obj/effect/turf_decal/tile/neutral{
	dir = 1
	},
/obj/effect/turf_decal/tile/neutral,
/obj/effect/turf_decal/tile/neutral{
	dir = 4
	},
/obj/effect/turf_decal/tile/neutral{
	dir = 8
	},
/turf/open/floor/plasteel/dark,
/area/external/shuttle/ruins/pirate_cutter)
"qd" = (
/mob/living/simple_animal/hostile/pirate{
	environment_smash = 0;
	loot = list(/obj/effect/mob_spawn/human/corpse/pirate)
	},
/turf/open/floor/plasteel,
/area/external/shuttle/ruins/pirate_cutter)
"qo" = (
/obj/machinery/porta_turret/syndicate/pod{
	dir = 6;
	faction = list("pirate")
	},
/turf/closed/wall/mineral/plastitanium,
/area/external/shuttle/ruins/pirate_cutter)
"qC" = (
/obj/structure/table,
/obj/item/storage/fancy/donut_box{
	pixel_y = 18
	},
/obj/item/storage/box/donkpockets{
	pixel_x = -3;
	pixel_y = 7
	},
/obj/item/storage/box/donkpockets{
	pixel_x = -6
	},
/obj/item/reagent_containers/food/drinks/bottle/rum{
	pixel_x = 8;
	pixel_y = 3
	},
/obj/structure/sign/poster/contraband/red_rum{
	pixel_x = 32
	},
/turf/open/floor/plasteel/dark,
/area/external/shuttle/ruins/pirate_cutter)
"qX" = (
/obj/structure/reagent_dispensers/watertank,
/obj/item/reagent_containers/glass/bucket,
/obj/item/mop,
/obj/effect/turf_decal/stripes/line{
	dir = 5
	},
/turf/open/floor/plating,
/area/external/shuttle/ruins/pirate_cutter)
"sr" = (
/obj/machinery/atmospherics/pipe/simple/supply/hidden{
	dir = 4
	},
/obj/effect/turf_decal/tile/red,
/obj/effect/turf_decal/tile/red{
	dir = 8
	},
/turf/open/floor/plasteel,
/area/external/shuttle/ruins/pirate_cutter)
"su" = (
/obj/effect/decal/cleanable/dirt,
/turf/open/floor/plasteel,
/area/external/shuttle/ruins/pirate_cutter)
"sW" = (
/obj/structure/table,
/obj/machinery/airalarm/all_access{
	pixel_y = 24
	},
/obj/effect/turf_decal/tile/neutral{
	dir = 1
	},
/obj/effect/turf_decal/tile/neutral,
/obj/effect/turf_decal/tile/neutral{
	dir = 4
	},
/obj/effect/turf_decal/tile/neutral{
	dir = 8
	},
/obj/item/storage/toolbox/syndicate,
/turf/open/floor/plasteel/dark,
/area/external/shuttle/ruins/pirate_cutter)
"to" = (
/obj/structure/table,
/obj/item/reagent_containers/food/drinks/bottle/rum{
	pixel_x = 3;
	pixel_y = 6
	},
/obj/item/reagent_containers/food/drinks/bottle/rum,
/turf/open/floor/plasteel/dark,
/area/external/shuttle/ruins/pirate_cutter)
"ul" = (
/obj/structure/table,
/obj/item/retractor,
/obj/item/hemostat,
/turf/open/floor/plasteel/white,
/area/external/shuttle/ruins/pirate_cutter)
"un" = (
/obj/machinery/atmospherics/pipe/simple/supply/hidden{
	dir = 4
	},
/obj/effect/turf_decal/tile/red{
	dir = 1
	},
/obj/effect/turf_decal/tile/red,
/obj/effect/turf_decal/tile/red{
	dir = 8
	},
/turf/open/floor/plasteel,
/area/external/shuttle/ruins/pirate_cutter)
"vd" = (
/obj/machinery/atmospherics/pipe/simple/supply/hidden{
	dir = 6
	},
/obj/effect/decal/cleanable/dirt,
/turf/open/floor/plasteel,
/area/external/shuttle/ruins/pirate_cutter)
"vW" = (
/obj/machinery/light/small{
	dir = 4
	},
/obj/machinery/atmospherics/pipe/simple/supply/hidden,
/turf/open/floor/plating,
/area/external/shuttle/ruins/pirate_cutter)
"wL" = (
/obj/machinery/button/door{
	id = "caravanpirate_bolt_port";
	name = "External Bolt Control";
	normaldoorcontrol = 1;
	pixel_x = -4;
	pixel_y = 25;
	specialfunctions = 4
	},
/obj/machinery/atmospherics/pipe/simple/supply/hidden{
	dir = 4
	},
/turf/open/floor/plasteel/white/side{
	dir = 1
	},
/area/external/shuttle/ruins/pirate_cutter)
"wX" = (
/obj/machinery/light/small{
	dir = 8
	},
/obj/effect/turf_decal/tile/red{
	dir = 1
	},
/obj/effect/turf_decal/tile/red{
	dir = 8
	},
/turf/open/floor/plasteel,
/area/external/shuttle/ruins/pirate_cutter)
"wZ" = (
/obj/machinery/atmospherics/pipe/manifold/supply/hidden{
	dir = 4
	},
/obj/effect/turf_decal/tile/neutral{
	dir = 1
	},
/obj/effect/turf_decal/tile/neutral,
/obj/effect/turf_decal/tile/neutral{
	dir = 4
	},
/obj/effect/turf_decal/tile/neutral{
	dir = 8
	},
/turf/open/floor/plasteel/dark,
/area/external/shuttle/ruins/pirate_cutter)
"xg" = (
/obj/structure/table,
/obj/machinery/microwave{
	pixel_y = 5
	},
/turf/open/floor/plasteel/dark,
/area/external/shuttle/ruins/pirate_cutter)
"yt" = (
/obj/structure/reagent_dispensers/fueltank,
/obj/effect/turf_decal/stripes/line{
	dir = 4
	},
/turf/open/floor/plating,
/area/external/shuttle/ruins/pirate_cutter)
"yu" = (
/obj/machinery/atmospherics/pipe/simple/supply/hidden{
	dir = 10
	},
/obj/effect/turf_decal/tile/neutral{
	dir = 1
	},
/obj/effect/turf_decal/tile/neutral,
/obj/effect/turf_decal/tile/neutral{
	dir = 4
	},
/obj/effect/turf_decal/tile/neutral{
	dir = 8
	},
/turf/open/floor/plasteel/dark,
/area/external/shuttle/ruins/pirate_cutter)
"yW" = (
/obj/machinery/atmospherics/components/unary/vent_pump/on{
	dir = 4
	},
/obj/machinery/space_heater,
/obj/effect/turf_decal/stripes/line{
	dir = 6
	},
/turf/open/floor/plating,
/area/external/shuttle/ruins/pirate_cutter)
"zB" = (
/obj/machinery/button/door{
	id = "caravanpirate_bolt_starboard";
	name = "External Bolt Control";
	normaldoorcontrol = 1;
	pixel_x = -4;
	pixel_y = -25;
	specialfunctions = 4
	},
/obj/machinery/atmospherics/pipe/simple/supply/hidden{
	dir = 4
	},
/obj/effect/turf_decal/tile/red,
/obj/effect/turf_decal/tile/red{
	dir = 8
	},
/turf/open/floor/plasteel,
/area/external/shuttle/ruins/pirate_cutter)
"Ag" = (
/obj/structure/table/optable,
/obj/effect/turf_decal/bot,
/turf/open/floor/plasteel/white,
/area/external/shuttle/ruins/pirate_cutter)
"Ah" = (
/obj/effect/mapping_helpers/airlock/cyclelink_helper{
	dir = 1
	},
/obj/effect/mapping_helpers/airlock/locked,
/obj/machinery/door/airlock/external{
	id_tag = "caravanpirate_bolt_starboard"
	},
/obj/machinery/door/firedoor/border_only{
	dir = 1
	},
/obj/machinery/door/firedoor/border_only,
/turf/open/floor/plating,
/area/external/shuttle/ruins/pirate_cutter)
"AP" = (
/obj/structure/sign/departments/medbay/alt,
/turf/closed/wall/mineral/plastitanium/nodiagonal,
/area/external/shuttle/ruins/pirate_cutter)
"BI" = (
/obj/structure/table,
/obj/machinery/light/small{
	brightness = 3;
	dir = 8
	},
/obj/item/stack/spacecash/c200,
/turf/open/floor/plasteel/dark,
/area/external/shuttle/ruins/pirate_cutter)
"BL" = (
/obj/structure/table,
/obj/machinery/cell_charger,
/obj/item/stack/cable_coil/yellow,
/obj/item/stock_parts/cell/high,
/obj/effect/turf_decal/bot,
/turf/open/floor/plating,
/area/external/shuttle/ruins/pirate_cutter)
"Cb" = (
/obj/structure/cable/yellow{
	icon_state = "0-2"
	},
/obj/machinery/power/apc{
	dir = 8;
	name = "Pirate Cutter APC";
	pixel_x = -25;
	req_access = null
	},
/obj/machinery/atmospherics/pipe/simple/supply/hidden,
/obj/machinery/airalarm/all_access{
	dir = 8;
	pixel_x = 24
	},
/turf/open/floor/plating,
/area/external/shuttle/ruins/pirate_cutter)
"DY" = (
/obj/structure/closet/crate/secure/loot,
/obj/machinery/airalarm/all_access{
	pixel_y = 24
	},
/turf/open/floor/plasteel/dark,
/area/external/shuttle/ruins/pirate_cutter)
"EK" = (
/obj/machinery/atmospherics/components/unary/vent_pump/on{
	dir = 1
	},
/turf/open/floor/plasteel,
/area/external/shuttle/ruins/pirate_cutter)
"FM" = (
/obj/machinery/power/terminal{
	dir = 1
	},
/obj/structure/cable{
	icon_state = "0-2"
	},
/obj/structure/closet/crate,
/obj/item/stack/sheet/metal/twenty,
/obj/item/stack/sheet/glass{
	amount = 10
	},
/obj/item/storage/toolbox/mechanical,
/obj/item/flashlight{
	pixel_x = 3;
	pixel_y = 3
	},
/obj/item/stack/sheet/mineral/plasma{
	amount = 20
	},
/obj/effect/turf_decal/stripes/line{
	dir = 4
	},
/turf/open/floor/plating,
/area/external/shuttle/ruins/pirate_cutter)
"Gh" = (
/obj/machinery/atmospherics/components/unary/tank/air,
/obj/effect/turf_decal/bot,
/turf/open/floor/plating,
/area/external/shuttle/ruins/pirate_cutter)
"Go" = (
/obj/structure/table/reinforced,
/obj/machinery/button/door{
	id = "caravanpirate_bridge";
	name = "Bridge Blast Door Control";
	pixel_x = 6;
	pixel_y = -5
	},
/obj/effect/turf_decal/tile/red,
/obj/effect/turf_decal/tile/red{
	dir = 8
	},
/turf/open/floor/plasteel/dark,
/area/external/shuttle/ruins/pirate_cutter)
"GQ" = (
/obj/machinery/light/small{
	dir = 4
	},
/obj/machinery/atmospherics/pipe/simple/supply/hidden{
	dir = 9
	},
/obj/effect/turf_decal/tile/red,
/obj/effect/turf_decal/tile/red{
	dir = 8
	},
/turf/open/floor/plasteel,
/area/external/shuttle/ruins/pirate_cutter)
"GR" = (
/obj/structure/table,
/obj/item/coin/gold,
/obj/item/coin/silver,
/obj/item/coin/silver,
/turf/open/floor/plasteel/dark,
/area/external/shuttle/ruins/pirate_cutter)
"HD" = (
/obj/structure/shuttle/engine/heater{
	dir = 8
	},
/obj/structure/window/reinforced{
	dir = 4
	},
/turf/open/floor/plating/airless,
/area/external/shuttle/ruins/pirate_cutter)
"II" = (
/obj/structure/closet/crate/freezer/surplus_limbs,
/obj/effect/turf_decal/bot,
/turf/open/floor/plasteel/white,
/area/external/shuttle/ruins/pirate_cutter)
"Jb" = (
/obj/effect/mapping_helpers/airlock/cyclelink_helper{
	dir = 2
	},
/obj/effect/mapping_helpers/airlock/locked,
/obj/machinery/door/airlock/external{
	id_tag = "caravanpirate_bolt_port"
	},
/obj/docking_port/mobile{
	callTime = 150;
	dir = 2;
	dwidth = 14;
	height = 13;
	shuttle_id = "caravanpirate";
	movement_force = list("KNOCKDOWN" = 0, "THROW" = 0);
	name = "Pirate Cutter";
	port_direction = 8;
	preferred_direction = 4;
	width = 22
	},
/obj/machinery/door/firedoor/border_only{
	dir = 1
	},
/obj/machinery/door/firedoor/border_only,
/turf/open/floor/plating,
/area/external/shuttle/ruins/pirate_cutter)
"Jv" = (
/turf/template_noop,
/area/template_noop)
"Kd" = (
/obj/machinery/sleeper{
	dir = 1
	},
/obj/effect/turf_decal/delivery,
/obj/machinery/airalarm/all_access{
	dir = 1;
	pixel_y = -24
	},
/turf/open/floor/plasteel/white,
/area/external/shuttle/ruins/pirate_cutter)
"Ku" = (
/obj/effect/mapping_helpers/airlock/cyclelink_helper{
	dir = 2
	},
/obj/effect/mapping_helpers/airlock/locked,
/obj/machinery/door/airlock/external{
	id_tag = "caravanpirate_bolt_starboard"
	},
/obj/machinery/door/firedoor/border_only{
	dir = 1
	},
/obj/machinery/door/firedoor/border_only,
/turf/open/floor/plating,
/area/external/shuttle/ruins/pirate_cutter)
"Ld" = (
/obj/machinery/suit_storage_unit/open,
/obj/effect/turf_decal/tile/neutral{
	dir = 1
	},
/obj/effect/turf_decal/tile/neutral,
/obj/effect/turf_decal/tile/neutral{
	dir = 4
	},
/obj/effect/turf_decal/tile/neutral{
	dir = 8
	},
/turf/open/floor/plasteel/dark,
/area/external/shuttle/ruins/pirate_cutter)
"Nx" = (
/obj/structure/shuttle/engine/propulsion/burst/right{
	dir = 8
	},
/turf/open/floor/plating/airless,
/area/external/shuttle/ruins/pirate_cutter)
"NM" = (
/obj/machinery/light/small{
	dir = 8
	},
/obj/structure/closet/crate/secure/loot,
/obj/machinery/atmospherics/components/unary/vent_pump/on{
	dir = 4
	},
/obj/structure/extinguisher_cabinet{
	pixel_x = -27
	},
/turf/open/floor/plasteel/dark,
/area/external/shuttle/ruins/pirate_cutter)
"Pc" = (
/obj/structure/sign/departments/engineering,
/turf/closed/wall/mineral/plastitanium/nodiagonal,
/area/external/shuttle/ruins/pirate_cutter)
"Pn" = (
/obj/structure/shuttle/engine/propulsion/burst/left{
	dir = 8
	},
/turf/open/floor/plating/airless,
/area/external/shuttle/ruins/pirate_cutter)
"Rq" = (
/obj/machinery/atmospherics/pipe/simple/supply/hidden{
	dir = 4
	},
/turf/open/floor/plasteel/white/side{
	dir = 9
	},
/area/external/shuttle/ruins/pirate_cutter)
"Rz" = (
/obj/effect/mapping_helpers/airlock/cyclelink_helper{
	dir = 1
	},
/obj/effect/mapping_helpers/airlock/locked,
/obj/machinery/door/airlock/external{
	id_tag = "caravanpirate_bolt_port"
	},
/obj/machinery/door/firedoor/border_only{
	dir = 1
	},
/obj/machinery/door/firedoor/border_only,
/turf/open/floor/plating,
/area/external/shuttle/ruins/pirate_cutter)
"RC" = (
/obj/machinery/atmospherics/pipe/simple/supply/hidden{
	dir = 4
	},
/obj/effect/turf_decal/tile/red{
	dir = 1
	},
/obj/effect/turf_decal/tile/red{
	dir = 8
	},
/turf/open/floor/plasteel/dark,
/area/external/shuttle/ruins/pirate_cutter)
"RK" = (
/obj/machinery/power/smes/fullycharged,
/obj/structure/cable/yellow{
	icon_state = "0-4"
	},
/obj/effect/turf_decal/stripes/line{
	dir = 5
	},
/turf/open/floor/plating,
/area/external/shuttle/ruins/pirate_cutter)
"Sd" = (
/obj/machinery/light/small{
	dir = 8
	},
/obj/structure/sign/warning/vacuum{
	pixel_x = -32
	},
/turf/open/floor/plating,
/area/external/shuttle/ruins/pirate_cutter)
"Sk" = (
/obj/machinery/atmospherics/pipe/simple/supply/hidden{
	dir = 4
	},
/obj/effect/turf_decal/tile/blue,
/obj/effect/turf_decal/tile/blue{
	dir = 4
	},
/turf/open/floor/plasteel/dark,
/area/external/shuttle/ruins/pirate_cutter)
"SF" = (
/obj/machinery/atmospherics/pipe/simple/supply/hidden{
	dir = 4
	},
/turf/open/floor/plasteel/dark/side{
	dir = 4
	},
/area/external/shuttle/ruins/pirate_cutter)
"SR" = (
/obj/machinery/atmospherics/pipe/simple/supply/hidden{
	dir = 9
	},
/obj/machinery/firealarm{
	dir = 1;
	pixel_y = -24
	},
/turf/open/floor/plasteel/dark,
/area/external/shuttle/ruins/pirate_cutter)
"UP" = (
/obj/structure/rack,
/obj/item/storage/toolbox/emergency,
/obj/item/weldingtool,
/obj/effect/turf_decal/tile/red{
	dir = 4
	},
/turf/open/floor/plasteel/dark,
/area/external/shuttle/ruins/pirate_cutter)
"Wb" = (
/obj/machinery/light/small,
/obj/structure/bed,
/obj/item/bedsheet/brown,
/turf/open/floor/plasteel/dark,
/area/external/shuttle/ruins/pirate_cutter)
"Xq" = (
/obj/structure/table/reinforced,
/obj/machinery/recharger,
/obj/item/melee/classic_baton,
/obj/effect/turf_decal/tile/red,
/turf/open/floor/plasteel/dark,
/area/external/shuttle/ruins/pirate_cutter)
"Yj" = (
/obj/machinery/porta_turret/syndicate/pod{
	dir = 9;
	faction = list("pirate")
	},
/turf/closed/wall/mineral/plastitanium,
/area/external/shuttle/ruins/pirate_cutter)
"Yo" = (
/obj/structure/table,
/obj/item/storage/box/lethalshot,
/obj/effect/turf_decal/tile/neutral{
	dir = 1
	},
/obj/effect/turf_decal/tile/neutral,
/obj/effect/turf_decal/tile/neutral{
	dir = 4
	},
/obj/effect/turf_decal/tile/neutral{
	dir = 8
	},
/turf/open/floor/plasteel/dark,
/area/external/shuttle/ruins/pirate_cutter)
"Yw" = (
/obj/machinery/atmospherics/pipe/simple/supply/hidden{
	dir = 4
	},
/turf/open/floor/plasteel/dark,
/area/external/shuttle/ruins/pirate_cutter)
"Zo" = (
/obj/machinery/atmospherics/pipe/simple/supply/hidden{
	dir = 5
	},
/turf/open/floor/plating,
/area/external/shuttle/ruins/pirate_cutter)
"ZY" = (
/obj/structure/chair/office/dark{
	dir = 8
	},
/obj/effect/turf_decal/tile/neutral{
	dir = 1
	},
/obj/effect/turf_decal/tile/neutral,
/obj/effect/turf_decal/tile/neutral{
	dir = 4
	},
/obj/effect/turf_decal/tile/neutral{
	dir = 8
	},
/turf/open/floor/plasteel/dark,
/area/external/shuttle/ruins/pirate_cutter)

(1,1,1) = {"
Jv
Jv
Jv
Pn
jU
Nx
Jv
Pn
jU
Nx
Jv
Jv
Jv
"}
(2,1,1) = {"
Jv
Jv
oL
HD
HD
HD
af
HD
HD
HD
oL
Jv
Jv
"}
(3,1,1) = {"
Jv
Yj
af
qX
yt
yW
af
RK
FM
jh
af
eL
Jv
"}
(4,1,1) = {"
Jv
af
Gh
kY
vW
fh
Cb
hI
vW
Zo
BL
af
Jv
"}
(5,1,1) = {"
Jv
af
af
ab
Pc
af
af
af
Pc
ab
af
af
Jv
"}
(6,1,1) = {"
Jv
af
Ld
Rq
oe
ul
af
Yo
wX
un
Ld
af
Jv
"}
(7,1,1) = {"
oL
af
af
na
su
Ag
af
sW
al
sr
af
af
oL
"}
(8,1,1) = {"
Jb
Sd
Rz
kl
EK
mI
af
pZ
pS
fU
Ku
Sd
Ah
"}
(9,1,1) = {"
oL
af
af
wL
su
Kd
af
oT
qd
zB
af
af
oL
"}
(10,1,1) = {"
Jv
aa
Ld
nD
bH
II
af
iX
vd
GQ
Ld
ao
Jv
"}
(11,1,1) = {"
Jv
oL
af
AP
ac
af
af
af
am
af
af
oL
Jv
"}
(12,1,1) = {"
Jv
Jv
af
aE
SF
ae
NM
fS
RC
oF
af
Jv
Jv
"}
(13,1,1) = {"
Jv
Jv
af
hT
yu
hZ
wZ
de
iF
Wb
af
Jv
Jv
"}
(14,1,1) = {"
Jv
Jv
le
af
xg
qC
pK
Sk
an
af
qo
Jv
Jv
"}
(15,1,1) = {"
Jv
Jv
Jv
oL
af
af
af
aj
af
oL
Jv
Jv
Jv
"}
(16,1,1) = {"
Jv
Jv
Jv
Jv
af
to
BI
Yw
af
Jv
Jv
Jv
Jv
"}
(17,1,1) = {"
Jv
Jv
Jv
Jv
af
GR
ZY
Yw
af
Jv
Jv
Jv
Jv
"}
(18,1,1) = {"
Jv
Jv
Jv
Jv
af
DY
lG
SR
af
Jv
Jv
Jv
Jv
"}
(19,1,1) = {"
Jv
Jv
Jv
Jv
af
UP
dE
Xq
af
Jv
Jv
Jv
Jv
"}
(20,1,1) = {"
Jv
Jv
Jv
Jv
aa
oO
gy
Go
ao
Jv
Jv
Jv
Jv
"}
(21,1,1) = {"
Jv
Jv
Jv
Jv
ad
ag
fL
ag
ak
Jv
Jv
Jv
Jv
"}
(22,1,1) = {"
Jv
Jv
Jv
Jv
Jv
ad
ai
ak
Jv
Jv
Jv
Jv
Jv
"}
