//MAP CONVERTED BY dmm2tgm.py THIS HEADER COMMENT PREVENTS RECONVERSION, DO NOT REMOVE
"a" = (
/turf/closed/wall/mineral/titanium/survival/pod,
/area/external/mining/survival_pod)
"b" = (
/obj/structure/sign/mining/survival{
	dir = 1
	},
/turf/closed/wall/mineral/titanium/survival/pod,
/area/external/mining/survival_pod)
"c" = (
/turf/closed/wall/mineral/titanium/survival/nodiagonal,
/area/external/mining/survival_pod)
"d" = (
/obj/structure/sign/mining/survival{
	dir = 1
	},
/turf/closed/wall/mineral/titanium/survival/nodiagonal,
/area/external/mining/survival_pod)
"e" = (
/obj/structure/sign/mining/survival{
	dir = 8
	},
/turf/closed/wall/mineral/titanium/survival/nodiagonal,
/area/external/mining/survival_pod)
"f" = (
/obj/structure/table/wood/fancy/black,
/obj/machinery/chem_dispenser/drinks,
/turf/open/floor/pod/dark,
/area/external/mining/survival_pod)
"g" = (
/obj/structure/table/wood/fancy/black,
/obj/machinery/chem_dispenser/drinks/beer,
/obj/machinery/light{
	dir = 1
	},
/turf/open/floor/pod/dark,
/area/external/mining/survival_pod)
"h" = (
/obj/machinery/vending/boozeomat,
/turf/open/floor/pod/dark,
/area/external/mining/survival_pod)
"i" = (
/obj/item/book/manual/wiki/barman_recipes,
/obj/item/reagent_containers/food/drinks/shaker,
/obj/item/reagent_containers/glass/rag,
/obj/structure/table/wood/fancy/black,
/turf/open/floor/pod/dark,
/area/external/mining/survival_pod)
"j" = (
/obj/structure/table/wood/fancy/black,
/obj/item/clipboard,
/obj/item/toy/figure/bartender,
/turf/open/floor/pod/dark,
/area/external/mining/survival_pod)
"k" = (
/obj/machinery/door/window/survival_pod,
/turf/open/floor/pod/dark,
/area/external/mining/survival_pod)
"l" = (
/obj/structure/table/wood/fancy/black,
/obj/structure/reagent_dispensers/beerkeg,
/turf/open/floor/pod/dark,
/area/external/mining/survival_pod)
"m" = (
/obj/structure/closet/secure_closet/bar,
/obj/machinery/light{
	dir = 1
	},
/turf/open/floor/pod/dark,
/area/external/mining/survival_pod)
"n" = (
/obj/structure/disposalpipe/trunk{
	dir = 4
	},
/obj/machinery/disposal/bin,
/turf/open/floor/pod/dark,
/area/external/mining/survival_pod)
"o" = (
/obj/structure/sign/mining/survival{
	dir = 4
	},
/obj/structure/disposalpipe/junction{
	dir = 4
	},
/turf/closed/wall/mineral/titanium/survival/pod,
/area/external/mining/survival_pod)
"q" = (
/turf/open/floor/pod/dark,
/area/external/mining/survival_pod)
"r" = (
/obj/structure/disposalpipe/segment,
/turf/closed/wall/mineral/titanium/survival/nodiagonal,
/area/external/mining/survival_pod)
"s" = (
/obj/structure/table/reinforced,
/obj/item/lighter{
	pixel_x = -4;
	pixel_y = 4
	},
/obj/item/lighter,
/turf/open/floor/pod/dark,
/area/external/mining/survival_pod)
"t" = (
/obj/structure/table/reinforced,
/turf/open/floor/pod/dark,
/area/external/mining/survival_pod)
"u" = (
/obj/structure/table/reinforced,
/obj/item/storage/box/matches{
	pixel_x = -4;
	pixel_y = 8
	},
/turf/open/floor/pod/dark,
/area/external/mining/survival_pod)
"w" = (
/obj/structure/sign/mining/survival{
	dir = 4
	},
/obj/structure/disposalpipe/segment,
/turf/closed/wall/mineral/titanium/survival/nodiagonal,
/area/external/mining/survival_pod)
"x" = (
/obj/structure/chair/stool/bar,
/turf/open/floor/carpet/black,
/area/external/mining/survival_pod)
"y" = (
/turf/open/floor/carpet/black,
/area/external/mining/survival_pod)
"z" = (
/obj/machinery/vending/cigarette/beach,
/turf/open/floor/carpet/black,
/area/external/mining/survival_pod)
"A" = (
/obj/structure/disposalpipe/trunk{
	dir = 4
	},
/obj/machinery/disposal/bin,
/turf/open/floor/carpet/black,
/area/external/mining/survival_pod)
"B" = (
/obj/structure/sign/mining/survival{
	dir = 4
	},
/obj/structure/disposalpipe/segment{
	dir = 9
	},
/turf/closed/wall/mineral/titanium/survival/nodiagonal,
/area/external/mining/survival_pod)
"C" = (
/obj/structure/window/reinforced/survival_pod{
	dir = 8
	},
/obj/structure/window/reinforced/survival_pod{
	dir = 4
	},
/obj/structure/window/reinforced/survival_pod{
	dir = 1
	},
/obj/structure/window/reinforced/survival_pod,
/obj/structure/grille,
/turf/open/floor/pod/dark,
/area/external/mining/survival_pod)
"D" = (
/obj/structure/chair/comfy/black,
/turf/open/floor/carpet/black,
/area/external/mining/survival_pod)
"E" = (
/obj/machinery/door/airlock/survival_pod,
/turf/open/floor/pod/light,
/area/external/mining/survival_pod)
"F" = (
/obj/structure/table/wood/fancy,
/obj/item/reagent_containers/food/condiment/peppermill{
	pixel_x = -4;
	pixel_y = 12
	},
/obj/item/reagent_containers/food/condiment/saltshaker{
	pixel_x = 4;
	pixel_y = 4
	},
/turf/open/floor/carpet/black,
/area/external/mining/survival_pod)
"G" = (
/obj/structure/urinal{
	pixel_y = 24
	},
/turf/open/floor/pod/light,
/area/external/mining/survival_pod)
"H" = (
/turf/open/floor/pod/light,
/area/external/mining/survival_pod)
"J" = (
/obj/structure/sign/mining/survival{
	dir = 4
	},
/turf/closed/wall/mineral/titanium/survival/nodiagonal,
/area/external/mining/survival_pod)
"K" = (
/obj/structure/chair/comfy/black{
	dir = 1
	},
/turf/open/floor/carpet/black,
/area/external/mining/survival_pod)
"L" = (
/obj/machinery/vending/snack/random,
/turf/open/floor/carpet/black,
/area/external/mining/survival_pod)
"M" = (
/obj/machinery/light,
/turf/open/floor/carpet/black,
/area/external/mining/survival_pod)
"N" = (
/obj/structure/toilet{
	dir = 8
	},
/obj/machinery/light/small{
	dir = 4
	},
/turf/open/floor/pod/light,
/area/external/mining/survival_pod)
"O" = (
/obj/structure/sign/mining/survival{
	dir = 4
	},
/turf/closed/wall/mineral/titanium/survival/pod,
/area/external/mining/survival_pod)
"P" = (
/obj/structure/sign/mining/survival,
/turf/closed/wall/mineral/titanium/survival/pod,
/area/external/mining/survival_pod)
"Q" = (
/obj/structure/sign/mining/survival,
/turf/closed/wall/mineral/titanium/survival/nodiagonal,
/area/external/mining/survival_pod)
"R" = (
/obj/machinery/door/airlock/survival_pod/glass,
/obj/structure/fans/tiny,
/turf/open/floor/carpet/black,
/area/external/mining/survival_pod)
"S" = (
/obj/structure/table/wood/fancy/black,
/obj/item/storage/fancy/cigarettes/cigars/cohiba,
/obj/item/storage/fancy/cigarettes/cigars/havana{
	pixel_y = 5
	},
/obj/item/storage/fancy/cigarettes/cigars{
	pixel_y = 10
	},
/turf/open/floor/pod/dark,
/area/external/mining/survival_pod)
"X" = (
/obj/structure/sink{
	dir = 4;
	pixel_x = 11
	},
/obj/machinery/light/small{
	dir = 1
	},
/turf/open/floor/pod/light,
/area/external/mining/survival_pod)
"Z" = (
/obj/structure/fans/tiny,
/obj/machinery/door/airlock/survival_pod/glass,
/turf/open/floor/pod/dark,
/area/external/mining/survival_pod)

(1,1,1) = {"
a
e
Z
e
c
e
C
e
C
e
a
"}
(2,1,1) = {"
b
f
q
s
x
y
D
F
K
L
P
"}
(3,1,1) = {"
c
g
q
t
x
y
y
y
y
M
c
"}
(4,1,1) = {"
d
h
q
t
x
y
D
F
K
y
Q
"}
(5,1,1) = {"
c
i
q
u
x
y
D
F
K
y
c
"}
(6,1,1) = {"
d
j
q
t
x
y
y
y
y
y
R
"}
(7,1,1) = {"
c
S
q
t
x
y
c
c
c
c
c
"}
(8,1,1) = {"
d
l
q
t
x
y
c
G
H
H
Q
"}
(9,1,1) = {"
c
m
q
k
y
y
E
H
c
E
c
"}
(10,1,1) = {"
b
n
q
t
z
A
c
X
c
N
P
"}
(11,1,1) = {"
a
o
r
w
r
B
c
J
c
O
a
"}
