//MAP CONVERTED BY dmm2tgm.py THIS HEADER COMMENT PREVENTS RECONVERSION, DO NOT REMOVE
"a" = (
/turf/closed/wall/mineral/titanium/survival/pod,
/area/external/mining/survival_pod)
"b" = (
/obj/structure/sign/mining/survival{
	dir = 1
	},
/turf/closed/wall/mineral/titanium/survival/pod,
/area/external/mining/survival_pod)
"d" = (
/obj/structure/sign/mining/survival{
	dir = 8
	},
/turf/closed/wall/mineral/titanium/survival/pod,
/area/external/mining/survival_pod)
"e" = (
/obj/structure/fans,
/turf/open/floor/pod,
/area/external/mining/survival_pod)
"f" = (
/obj/machinery/smartfridge/survival_pod,
/turf/open/floor/pod,
/area/external/mining/survival_pod)
"g" = (
/obj/item/gps/computer,
/turf/open/floor/pod,
/area/external/mining/survival_pod)
"h" = (
/obj/machinery/shower,
/obj/item/soap/deluxe,
/obj/structure/curtain{
	alpha = 240;
	color = "#454545";
	icon_state = "closed";
	open = 0
	},
/turf/open/floor/pod,
/area/external/mining/survival_pod)
"i" = (
/obj/structure/toilet/secret{
	secret_type = /obj/item/kitchen/knife/combat/survival
	},
/turf/open/floor/pod,
/area/external/mining/survival_pod)
"j" = (
/obj/structure/sign/mining/survival{
	dir = 4
	},
/turf/closed/wall/mineral/titanium/survival/pod,
/area/external/mining/survival_pod)
"k" = (
/obj/machinery/sleeper/survival_pod,
/turf/open/floor/pod,
/area/external/mining/survival_pod)
"l" = (
/turf/open/floor/pod,
/area/external/mining/survival_pod)
"m" = (
/obj/structure/bed/pod,
/obj/item/bedsheet/black,
/turf/open/floor/pod,
/area/external/mining/survival_pod)
"n" = (
/obj/structure/window/reinforced/survival_pod{
	dir = 8;
	layer = 3
	},
/obj/machinery/door/window/survival_pod{
	dir = 1;
	icon_state = "windoor"
	},
/turf/open/floor/carpet/black,
/area/external/mining/survival_pod)
"o" = (
/obj/structure/chair/comfy/black,
/obj/item/cardboard_cutout{
	desc = "A cardboard cutout of a xenomorph maid.";
	icon_state = "cutout_lusty";
	name = "lusty xenomorph maid"
	},
/obj/structure/window/reinforced/survival_pod{
	dir = 1
	},
/turf/open/floor/carpet/black,
/area/external/mining/survival_pod)
"p" = (
/obj/structure/table/survival_pod,
/obj/item/storage/firstaid/regular,
/obj/item/storage/firstaid/brute{
	pixel_x = 5
	},
/turf/open/floor/pod,
/area/external/mining/survival_pod)
"q" = (
/obj/structure/tubes,
/obj/item/kirbyplants/random,
/turf/open/floor/pod,
/area/external/mining/survival_pod)
"r" = (
/obj/structure/window/reinforced/survival_pod{
	dir = 8
	},
/turf/open/floor/carpet/black,
/area/external/mining/survival_pod)
"s" = (
/obj/machinery/light{
	dir = 4;
	light_color = "#DDFFD3"
	},
/obj/structure/table/wood/fancy/black,
/obj/item/reagent_containers/food/drinks/drinkingglass{
	pixel_x = 7;
	pixel_y = 2
	},
/obj/item/reagent_containers/food/drinks/bottle/wine{
	pixel_x = -6;
	pixel_y = 10
	},
/turf/open/floor/carpet/black,
/area/external/mining/survival_pod)
"t" = (
/obj/machinery/microwave{
	pixel_y = -2
	},
/obj/structure/window/reinforced/survival_pod{
	dir = 1
	},
/obj/structure/table/wood/fancy/black{
	pixel_y = -9
	},
/turf/open/floor/carpet/black,
/area/external/mining/survival_pod)
"u" = (
/obj/machinery/door/window/survival_pod{
	dir = 1;
	icon_state = "windoor"
	},
/turf/open/floor/carpet/black,
/area/external/mining/survival_pod)
"v" = (
/obj/structure/window/reinforced/survival_pod{
	dir = 1
	},
/obj/structure/displaycase{
	alert = 0;
	desc = "A display case containing an expensive forgery, probably.";
	pixel_y = -4;
	start_showpiece_type = /obj/item/fakeartefact;
	req_access = list("mining")
	},
/turf/open/floor/carpet/black,
/area/external/mining/survival_pod)
"w" = (
/obj/structure/window/reinforced/survival_pod{
	density = 0;
	dir = 9
	},
/turf/open/floor/carpet/black,
/area/external/mining/survival_pod)
"x" = (
/obj/structure/table/wood/fancy/black,
/obj/item/reagent_containers/food/drinks/drinkingglass{
	pixel_x = 7;
	pixel_y = 2
	},
/obj/effect/spawner/lootdrop/three_course_meal,
/turf/open/floor/carpet/black,
/area/external/mining/survival_pod)
"y" = (
/obj/structure/sink/kitchen{
	dir = 4;
	icon_state = "sink_alt";
	pixel_x = -13
	},
/turf/open/floor/carpet/black,
/area/external/mining/survival_pod)
"z" = (
/obj/machinery/light,
/turf/open/floor/carpet/black,
/area/external/mining/survival_pod)
"A" = (
/turf/open/floor/carpet/black,
/area/external/mining/survival_pod)
"B" = (
/obj/structure/chair/comfy/black{
	dir = 1
	},
/turf/open/floor/carpet/black,
/area/external/mining/survival_pod)
"C" = (
/obj/structure/sign/mining/survival,
/turf/closed/wall/mineral/titanium/survival/pod,
/area/external/mining/survival_pod)
"D" = (
/obj/structure/fans/tiny,
/obj/machinery/door/airlock/survival_pod/glass,
/turf/open/floor/pod,
/area/external/mining/survival_pod)
"E" = (
/obj/structure/sign/mining,
/turf/closed/wall/mineral/titanium/survival/pod,
/area/external/mining/survival_pod)

(1,1,1) = {"
a
d
a
d
a
d
a
"}
(2,1,1) = {"
b
e
k
p
t
y
C
"}
(3,1,1) = {"
a
f
l
l
u
z
a
"}
(4,1,1) = {"
b
g
m
q
v
A
D
"}
(5,1,1) = {"
a
h
n
r
w
A
a
"}
(6,1,1) = {"
b
i
o
s
x
B
E
"}
(7,1,1) = {"
a
j
a
j
a
j
a
"}
